concept_sportsteam_bridgewater_state_bears	concept:agentcollaborateswithagent	concept_personmexico_ncaa
concept_personmexico_ncaa	concept:agentcontrols	concept_sportsteam_george_washington_colonials
concept_bodypart_system001	concept:bodypartcontainsbodypart	concept_archaea_pathogens
concept_city_home	concept:atdate	concept_date_nov__4
concept_visualizablething_climate_control	concept:subpartof	concept_weatherphenomenon_air
concept_agriculturalproduct_crops	concept:agriculturalproductincludingagriculturalproduct	concept_vegetable_pumpkins
concept_city_leawood	concept:atlocation	concept_stateorprovince_kansas
concept_geometricshape_right_angle	concept:thinghasshape	concept_geometricshape_angle
concept_chemical_water	concept:chemicalistypeofchemical	concept_chemical_common_chemicals
concept_personcanada_korn	concept:agentcollaborateswithagent	concept_musician_jonathan_davis
concept_sportsgame_ten_days	concept:atdate	concept_dateliteral_n2005
concept_hallwayitem_fan	concept:mutualproxyfor	concept_book_new
concept_sportsteam_nebraska_kearney_lopers	concept:agentcollaborateswithagent	concept_personmexico_ncaa
concept_arthropod_invertebrates	concept:animalsuchasinvertebrate	concept_invertebrate_polychaetes
concept_beverage_vinegar	concept:beveragemadefrombeverage	concept_beverage_juice
concept_televisionstation_waow_tv	concept:subpartof	concept_website_abc
concept_cognitiveactions_three_hours	concept:proxyfor	concept_musicinstrument_new
concept_city_krasnodar	concept:locationlocatedwithinlocation	concept_country_russia
concept_biotechcompany_csx_corporation	concept:agentcontrols	concept_weatherphenomenon_snow
concept_profession_services_department	concept:synonymfor	concept_governmentorganization_department
concept_personaustralia_chuck_james	concept:agentcollaborateswithagent	concept_mollusk_rays
concept_bird_swifts	concept:agentcompeteswithagent	concept_animal_birds002
concept_city_romeoville	concept:atlocation	concept_stateorprovince_illinois
concept_personeurope_jonathan_miller	concept:proxyfor	concept_mldataset_aol
concept_plant_greenhouse	concept:plantgrowinginplant	concept_plant_plants
concept_fish_big_game_fish	concept:animalsuchasfish	concept_fish_shark
concept_televisionstation_kfmb	concept:subpartof	concept_website_cbs
concept_city_kenansville	concept:atlocation	concept_city_florida
concept_beach_phenix_city	concept:proxyfor	concept_newspaper_alabama
concept_river_reward	concept:proxyfor	concept_book_new
concept_city_las_cruces	concept:proxyfor	concept_stateorprovince_new_mexico
concept_male_maximian	concept:fatherofperson	concept_monarch_maxentius
concept_winery_hartford	concept:mutualproxyfor	concept_personeurope_eddie_perez
concept_buildingfeature_conservatory	concept:subpartof	concept_weatherphenomenon_air
concept_museum_facilities	concept:subpartof	concept_visualizablething_safe_drinking_water
concept_personus_brad_penny	concept:agentcollaborateswithagent	concept_sportsleague_mlb
concept_city_korla	concept:locationlocatedwithinlocation	concept_country_china
concept_landscapefeatures_states	concept:locationlocatedwithinlocation	concept_geopoliticallocation_central_europe
concept_politicalparty_types	concept:agentcompeteswithagent	concept_personcanada_search
concept_governmentorganization_first_district	concept:proxyfor	concept_coach_new
concept_county_new_mexico_state_university	concept:agentcontrols	concept_coach_reggie_theus
concept_eventoutcome_difficulty	concept:proxyfor	concept_book_new
concept_artery_ventricle	concept:bodypartcontainsbodypart	concept_vein_systemic_circulation
concept_city_bell_gardens	concept:locationlocatedwithinlocation	concept_stateorprovince_california
concept_transportation_csx	concept:subpartof	concept_personmexico_thomas_ward
concept_bacteria_ethanol_production	concept:atdate	concept_dateliteral_n2006
concept_weapon_national	concept:atlocation	concept_city_breezy_point
concept_profession_faculty	concept:professionistypeofprofession	concept_jobposition_advisor
concept_jobposition_internal_medicine	concept:atdate	concept_dateliteral_n2006
concept_personaustralia_clerk	concept:proxyfor	concept_book_new
concept_comedian_medicine	concept:agentcompeteswithagent	concept_tradeunion_article
concept_mammal_marsupials	concept:mammalsuchasmammal	concept_mammal_koala
concept_sportsteam_hunter_college	concept:agentcollaborateswithagent	concept_personmexico_ncaa
concept_mammal_bear	concept:mammalsuchasmammal	concept_mammal_musk_ox
concept_city_new_ulm	concept:atlocation	concept_stateorprovince_minnesota
concept_emotion_dna	concept:atdate	concept_dateliteral_n2002
concept_county_california_state_university_channel_islands	concept:atlocation	concept_county_los_angeles_county
concept_geopoliticallocation_keshod	concept:locationlocatedwithinlocation	concept_country_republic_of_india
concept_personasia_hyderabad	concept:atdate	concept_date_n2001
concept_beverage_cassis	concept:beveragemadefrombeverage	concept_beverage_juice
concept_terroristorganization_mahmoud_abbas	concept:agentcontrols	concept_terroristorganization_fatah
concept_biotechcompany_colgate_palmolive	concept:agentcontrols	concept_skiarea_maine
concept_newspaper_port_st__lucie	concept:proxyfor	concept_city_florida
concept_county_delaware_valley	concept:proxyfor	concept_coach_new
concept_website_wwmt	concept:subpartof	concept_website_cbs
concept_automobilemaker_statement	concept:agentcontrols	concept_hotel_clarence
concept_building_home_depot	concept:synonymfor	concept_mldataset_hd
concept_beverage_livingston	concept:mutualproxyfor	concept_radiostation_new_jersey
concept_radiostation_lima	concept:proxyfor	concept_vertebrate_peru
concept_city_monte_vista	concept:atlocation	concept_stateorprovince_colorado
concept_musicalbum_grand_prix	concept:atdate	concept_dateliteral_n2006
concept_academicfield_technology	concept:academicfieldsuchasacademicfield	concept_politicsissue_master_s_degree
concept_food_oil	concept:agriculturalproductincludingagriculturalproduct	concept_fruit_sunflower_seed
concept_city_kramfors	concept:locationlocatedwithinlocation	concept_city_sweden
concept_televisionstation_wnem_tv	concept:subpartof	concept_website_cbs
concept_chemical_links	concept:specializationof	concept_chemical_statistics
concept_city_crestline	concept:atlocation	concept_stateorprovince_california
concept_beverage_new	concept:atlocation	concept_room_township
concept_drug_december_19	concept:proxyfor	concept_book_new
concept_agriculturalproduct_products	concept:agriculturalproductincludingagriculturalproduct	concept_meat_bacon
concept_visualizablething_episodes	concept:atdate	concept_dateliteral_n2008
concept_sportsteam_ashland_eagles	concept:agentcollaborateswithagent	concept_personmexico_ncaa
concept_city_tuscaloosa	concept:atlocation	concept_stateorprovince_alabama
concept_personmexico_ncaa	concept:agentcontrols	concept_sportsteam_siena_saints
concept_book_new	concept:mutualproxyfor	concept_bedroomitem_piece
concept_ceo_kumar_birla	concept:proxyfor	concept_company_hindalco
concept_fish_squadron	concept:atdate	concept_dateliteral_n1943
concept_beverage_red_wine_vinegar	concept:beveragemadefrombeverage	concept_beverage_juice
concept_beverage_margarita	concept:beveragemadefrombeverage	concept_beverage_juice
concept_publication_prentice_hall	concept:atdate	concept_dateliteral_n2005
concept_race_national_championships	concept:atdate	concept_dateliteral_n2008
concept_televisionstation_wcvw	concept:subpartof	concept_museum_pbs
concept_musicalbum_tallulah	concept:atlocation	concept_attraction_louisiana
concept_mldataset_east_coast	concept:proxyfor	concept_book_new
concept_city_silver_city	concept:locationlocatedwithinlocation	concept_stateorprovince_new_mexico
concept_person_chris	concept:agentcontrols	concept_charactertrait_world
concept_lake_new	concept:locationlocatedwithinlocation	concept_museum_requirements
concept_sociopolitical_easy_task	concept:proxyfor	concept_book_new
concept_academicfield_technology	concept:academicfieldsuchasacademicfield	concept_academicfield_graduate_degree
concept_company_ibm	concept:acquired	concept_winery_solid_information_technology
concept_female_yankees	concept:agentcollaborateswithagent	concept_personus_a_j__burnett
concept_musicsong_good_friend	concept:proxyfor	concept_weatherphenomenon_new
concept_bodypart_human	concept:bodypartcontainsbodypart	concept_bodypart_cells001
concept_book_stay	concept:atdate	concept_date_apr
concept_personmexico_sf_giants	concept:atlocation	concept_county_san_francisco
concept_actor_collectors	concept:proxyfor	concept_book_new
concept_city_contact	concept:atdate	concept_dateliteral_n2006
concept_musicartist_american	concept:atlocation	concept_building_norwich
concept_city_boston	concept:proxyfor	concept_stadiumoreventvenue_bank_of_america_pavilion
concept_city_enfield	concept:atlocation	concept_stateorprovince_connecticut
concept_sportsteam_alaska_seawolves	concept:agentcollaborateswithagent	concept_personmexico_ncaa
concept_lake_new	concept:locationlocatedwithinlocation	concept_park_arena_hotel
concept_musicfestival_second_conference	concept:atdate	concept_dateliteral_n2007
concept_agriculturalproduct_supplements	concept:agriculturalproductincludingagriculturalproduct	concept_food_meal
concept_plant_bean	concept:plantgrowinginplant	concept_visualizablething_tree
concept_physicalaction_chain	concept:proxyfor	concept_book_new
concept_bodypart_contraction	concept:bodypartcontainsbodypart	concept_bodypart_system001
concept_buildingfeature_american	concept:atlocation	concept_city_luttrell
concept_personus_complaints	concept:atdate	concept_date_n2003
concept_city_weehawken	concept:proxyfor	concept_stateorprovince_new_jersey
concept_book_traffic	concept:proxyfor	concept_eventoutcome_new
concept_buildingfeature_american	concept:atlocation	concept_city_redan
concept_scientificterm_markov_random_fields	concept:conceptprerequisiteof	concept_scientificterm_factor_graphs
concept_parlourgame_five_hours	concept:proxyfor	concept_book_new
concept_hobby_theology	concept:atdate	concept_dateliteral_n2008
concept_personaustralia_william_moore	concept:agentcollaborateswithagent	concept_company_nbc
concept_city_kastoria	concept:locationlocatedwithinlocation	concept_country_greece
concept_academicfield_biology	concept:academicfieldsuchasacademicfield	concept_academicfield_ecology
concept_attraction_vacations	concept:proxyfor	concept_book_new
concept_website_wsmv	concept:subpartof	concept_retailstore_nbc
concept_televisionstation_kdrv_tv	concept:subpartof	concept_website_abc
concept_city_central	concept:cityalsoknownas	concept_island_manhattan
concept_city_knock	concept:locationlocatedwithinlocation	concept_country_ireland
concept_musicalbum_autumn	concept:proxyfor	concept_weatherphenomenon_new
concept_profession_instruction	concept:professionistypeofprofession	concept_profession_staff
concept_city_ocean_grove	concept:proxyfor	concept_stateorprovince_newjersey
concept_academicfield_biology	concept:academicfieldsuchasacademicfield	concept_academicfield_human_genetics
concept_academicfield_technology	concept:academicfieldsuchasacademicfield	concept_academicfield_applied_mechanics
concept_hobby_wetlands	concept:proxyfor	concept_book_new
concept_profession_associate	concept:synonymfor	concept_politicsissue_advancement
concept_city_sun_valley	concept:proxyfor	concept_newspaper_idaho
concept_stateorprovince_contrast	concept:proxyfor	concept_book_new
concept_city_abc	concept:agentcontrols	concept_website_wytv
concept_televisionshow_jersey_shore	concept:proxyfor	concept_book_new
concept_sportsequipment_trade_association	concept:proxyfor	concept_book_new
concept_personafrica_hrithik_roshan	concept:parentofperson	concept_actor_rakesh_roshan
concept_city_garfield_heights	concept:atlocation	concept_stateorprovince_ohio
concept_university_state_university	concept:synonymfor	concept_university_kent_state
concept_company_nbc	concept:agentcontrols	concept_website_ksee
concept_race_three_times	concept:proxyfor	concept_politicaloffice_new
concept_politicianus_barney_frank	concept:politicianusendorsedbypoliticianus	concept_politicianus_bush
concept_scientificterm_statistical_hypothesis_testing	concept:conceptprerequisiteof	concept_scientificterm_comparing_normal_populations
concept_hotel_hotel___casino	concept:locationlocatedwithinlocation	concept_building_vegas
concept_chemical_pipes	concept:subpartof	concept_visualizablething_drain
concept_biotechcompany_parsons	concept:atlocation	concept_city_kansas
concept_city_safety_harbor	concept:atlocation	concept_city_florida
concept_lake_new	concept:locationlocatedwithinlocation	concept_landscapefeatures_campus
concept_beverage_chai	concept:beveragemadefrombeverage	concept_beverage_black_tea
concept_male_abraham	concept:fatherofperson	concept_monarch_isaac_
concept_agriculturalproduct_products	concept:agriculturalproductincludingagriculturalproduct	concept_agriculturalproduct_lamb
concept_scientist_scholars	concept:atdate	concept_dateliteral_n2008
concept_city_king_city	concept:atlocation	concept_stateorprovince_california
concept_city_chanute	concept:atlocation	concept_stateorprovince_kansas
concept_physicalaction_bonds	concept:subpartof	concept_weatherphenomenon_water
concept_city_charlotte_amalie	concept:proxyfor	concept_island_us_virgin_islands
concept_city_petoskey	concept:atlocation	concept_stateorprovince_michigan
concept_geopoliticallocation_facilitator	concept:proxyfor	concept_book_new
concept_visualartmovement_poet	concept:proxyfor	concept_book_new
concept_profession_senior_staff	concept:professionistypeofprofession	concept_profession_members
concept_lake_big_spring	concept:locationlocatedwithinlocation	concept_city_texas
concept_ceo_wipro	concept:mutualproxyfor	concept_personeurope_azim_premji
concept_newspaper_journal	concept:competeswith	concept_blog_ft_com
concept_athlete_bob_oliver	concept:parentofperson	concept_athlete_darren_o_day
concept_agriculturalproduct_crops	concept:agriculturalproductincludingagriculturalproduct	concept_fruit_sugar_beet
concept_male_last_day	concept:proxyfor	concept_book_new
concept_weapon_national	concept:atlocation	concept_city_mira_loma
concept_blog_myspace	concept:acquired	concept_biotechcompany_newscorp
concept_city_jefferson	concept:proxyfor	concept_creditunion_north_carolina
concept_bodypart_system002	concept:bodypartcontainsbodypart	concept_braintissue_gallbladder
concept_city_paragould	concept:proxyfor	concept_stateorprovince_arkansas
concept_county_sulphur	concept:atlocation	concept_attraction_louisiana
concept_city_murray	concept:locationlocatedwithinlocation	concept_stateorprovince_utah
concept_academicfield_sciences	concept:academicfieldsuchasacademicfield	concept_academicfield_ethnology
concept_profession_dealers	concept:professionistypeofprofession	concept_profession_professionals
concept_city_providence	concept:proxyfor	concept_stadiumoreventvenue_dunkin__donuts_center
concept_weatherphenomenon_greater	concept:atlocation	concept_stateorprovince_california
concept_river_congo_river	concept:riveremptiesintoriver	concept_river_congo
concept_sportsleague_mlb	concept:agentcontrols	concept_personmexico_tampa_bay_rays
concept_city_monte_carlo	concept:locationlocatedwithinlocation	concept_city_vegas
concept_newspaper_koin	concept:subpartof	concept_website_cbs
concept_shoppingmall_moorestown	concept:mutualproxyfor	concept_radiostation_new_jersey
concept_stateorprovince_states	concept:stateorprovinceisborderedbystateorprovince	concept_stateorprovince_md
concept_city_siloam_springs	concept:atlocation	concept_stateorprovince_arkansas
concept_biotechcompany_ibm	concept:acquired	concept_biotechcompany_rational_software
concept_organization_orinats_yerkir__rule_of_law__party	concept:subpartof	concept_ethnicgroup_armenia
concept_architect_enid	concept:subpartof	concept_musicsong_oklahoma
concept_academicfield_science	concept:academicfieldsuchasacademicfield	concept_academicfield_physical_education
concept_county_the_new_school	concept:atlocation	concept_island_new_york_city_metropolitan_area
concept_city_abbeville	concept:atlocation	concept_stateorprovince_louisiana
concept_radiostation_canton	concept:proxyfor	concept_automobilemaker_china
concept_city_biddeford	concept:atlocation	concept_stateorprovince_maine
concept_weapon_shooting	concept:atdate	concept_dateliteral_n2006
concept_monarch_veteran	concept:agentcontrols	concept_olympics_walter_cronkite
concept_religion_american	concept:atlocation	concept_mountain_clarkdale
concept_crustacean_spinnerbaits	concept:animalsuchasfish	concept_fish_bass
concept_company_badr_organization	concept:subpartof	concept_person_abdul_aziz_al_hakin
concept_fish_anglers	concept:proxyfor	concept_lake_new
concept_televisionstation_wybe	concept:subpartof	concept_museum_pbs
concept_county_sea_isle_city	concept:mutualproxyfor	concept_radiostation_new_jersey
concept_academicfield_science	concept:academicfieldsuchasacademicfield	concept_academicfield_economy
concept_fish_alligator	concept:agentcollaborateswithagent	concept_person_bruce_iglauer
concept_charactertrait_printer	concept:atdate	concept_dateliteral_n2006
concept_visualizablething_management_programs	concept:subpartof	concept_weatherphenomenon_water
concept_person_roman	concept:hassibling	concept_monarch_titus
concept_company_continental_airlines001	concept:mutualproxyfor	concept_ceo_jeff_smisek
concept_sportsteam_packers	concept:teamalsoknownas	concept_sportsteam_detroit_lions
concept_buildingfeature_shipping	concept:atdate	concept_dateliteral_n2008
concept_skiarea_troy	concept:proxyfor	concept_company_new_york
concept_politicsissue_bags	concept:atdate	concept_dateliteral_n2007
concept_person_york	concept:subpartof	concept_nongovorganization_u_s_
concept_musicartist_longview	concept:atlocation	concept_city_washington_d_c
concept_visualizablescene_porbandar	concept:proxyfor	concept_stateorprovince_gujarat
concept_bathroomitem_new	concept:subpartof	concept_weatherphenomenon_services
concept_mammal_deer	concept:mammalsuchasmammal	concept_mammal_porcupine
concept_televisionstation_klby	concept:subpartof	concept_website_abc
concept_personmexico_ncaa	concept:agentcontrols	concept_sportsteam_arizona_state_sun_devils
concept_musicartist_abbas	concept:agentcontrols	concept_terroristorganization_fatah_movement
concept_sportsteam_montclair_state_red_hawks	concept:agentcollaborateswithagent	concept_personmexico_ncaa
concept_city_westport	concept:proxyfor	concept_stateorprovince_connecticut
concept_mldataset_dealers	concept:proxyfor	concept_book_new
concept_stadiumoreventvenue_salt_palace_convention_center	concept:atlocation	concept_beach_salt_lake_city_ogden
concept_hotel_casino_las_vegas	concept:locationlocatedwithinlocation	concept_building_vegas
concept_protein_toll	concept:proxyfor	concept_book_new
concept_clothing_lining	concept:subpartof	concept_website_blood
concept_bodypart_atrium	concept:bodypartcontainsbodypart	concept_artery_four_pulmonary_veins
concept_company_new_york	concept:competeswith	concept_newspaper_the_san_francisco_examiner
concept_animal_flock	concept:animalpreyson	concept_animal_birds002
concept_weapon_national	concept:atlocation	concept_geopoliticalorganization_brea
concept_mountain_fox	concept:agentcontrols	concept_website_wfld
concept_traditionalgame_trump	concept:subpartof	concept_traditionalgame_vegas
concept_county_bloomsburg	concept:proxyfor	concept_stateorprovince_pennsylvania
concept_agriculturalproduct_crops	concept:agriculturalproductincludingagriculturalproduct	concept_grain_millets
concept_sportsteam_coppin_state_eagles	concept:agentcollaborateswithagent	concept_personmexico_ncaa
concept_sportsteam_huntington_foresters	concept:agentcollaborateswithagent	concept_personmexico_ncaa
concept_fish_large_fish	concept:animalsuchasfish	concept_fish_skate
concept_automobilemaker_view	concept:competeswith	concept_blog_google
concept_animal_creatures	concept:agentcompeteswithagent	concept_personasia_grasshoppers
concept_stateorprovince_states	concept:stateorprovinceisborderedbystateorprovince	concept_stateorprovince_bauchi
concept_sportsgame_schedules	concept:proxyfor	concept_book_new
concept_televisionnetwork_cbs	concept:agentcollaborateswithagent	concept_politicianus_mike_wallace
concept_personus_mike_macdougal	concept:agentcollaborateswithagent	concept_sportsleague_mlb
concept_animal_ocean_fish	concept:animalsuchasfish	concept_fish_tuna
concept_city_central_coast	concept:mutualproxyfor	concept_stateorprovince_california
concept_city_skillman	concept:proxyfor	concept_radiostation_new_jersey
concept_street_first_road	concept:atdate	concept_dayofweek_saturday
concept_city_abc	concept:agentcontrols	concept_publication_wpbf_tv
concept_city_abc	concept:agentcollaborateswithagent	concept_person_jake_tapper
concept_lake_barefoot_bay	concept:atlocation	concept_city_florida
concept_publication_annual_report	concept:atdate	concept_dateliteral_n2006
concept_website_kgan	concept:subpartof	concept_website_cbs
concept_politicianus_william	concept:politicianusendorsedbypoliticianus	concept_politicianus_john_smith
concept_animal_organisms	concept:animalsuchasinvertebrate	concept_animal_man
concept_musician_the_beach_boys	concept:agentcontrols	concept_personcanada_brian_wilson
concept_terroristorganization_autonomy	concept:mutualproxyfor	concept_person_mike_lynch
concept_physiologicalcondition_ill_health	concept:ismultipleof	concept_publication_people_
concept_personcanada_search	concept:agentcompeteswithagent	concept_ceo_index_this_page
concept_city_norman	concept:locationlocatedwithinlocation	concept_stateorprovince_oklahoma
concept_academicfield_science	concept:academicfieldsuchasacademicfield	concept_academicfield_business_marketing
concept_invertebrate_topwater_lures	concept:animalsuchasfish	concept_fish_bass
concept_city_spartanburg	concept:proxyfor	concept_stateorprovince_south_carolina
concept_jobposition_deputy_prime_minister	concept:atdate	concept_date_n2003
concept_website_wjhl_tv	concept:subpartof	concept_website_cbs
concept_sportsteam_blue_jays	concept:agentcontrols	concept_athlete_frank_thomas
concept_politicianus_sen__hillary_rodham_clinton	concept:politicianusendorsedbypoliticianus	concept_politician_clinton
concept_musicartist_nine_days	concept:proxyfor	concept_book_new
concept_governmentorganization_services	concept:organizationalsoknownas	concept_governmentorganization_south_australian_department
concept_city_father	concept:atdate	concept_year_n1873
concept_city_kues	concept:subpartof	concept_museum_pbs
concept_county_west_greenwich	concept:locationlocatedwithinlocation	concept_monument_rhode_island
concept_beverage_column	concept:proxyfor	concept_book_new
concept_hobby_mentors	concept:proxyfor	concept_book_new
concept_insect_dry_flies	concept:animalsuchasfish	concept_fish_trout
concept_city_garland	concept:proxyfor	concept_stateorprovince_texas
concept_chemical_sodium_bisulfite	concept:chemicalistypeofchemical	concept_chemical_sulfur
concept_museum_freer	concept:atlocation	concept_city_washington_d_c
concept_bodypart_system002	concept:bodypartcontainsbodypart	concept_braintissue_smell
concept_sportsteam_chivas	concept:subpartof	concept_room_mls
concept_bodypart_blood	concept:bodypartcontainsbodypart	concept_bone_joint
concept_musician_green_day	concept:agentcollaborateswithagent	concept_musician_billie_joe_armstrong
concept_academicfield_sciences	concept:academicfieldsuchasacademicfield	concept_academicfield_plant_pathology
concept_company_new_york	concept:competeswith	concept_newspaper_new_york_observer
concept_emotion_disappointment	concept:proxyfor	concept_book_new
concept_city_koszalin	concept:locationlocatedwithinlocation	concept_country_poland
concept_musicsong_passion	concept:proxyfor	concept_weatherphenomenon_new
concept_river_columbia	concept:riveremptiesintoriver	concept_river_lower_fraser_valley
concept_company_ibm	concept:acquired	concept_company_filenet
concept_bodypart_right_arm	concept:subpartof	concept_website_blood
concept_agriculturalproduct_products	concept:agriculturalproductincludingagriculturalproduct	concept_visualizableobject_red_meat
concept_politicianus_booth	concept:hassibling	concept_person_lincoln
concept_charactertrait_system_performance	concept:subpartof	concept_weatherphenomenon_air
concept_magazine_charlotte	concept:proxyfor	concept_musicfestival_ovens_auditorium
concept_bodypart_system002	concept:bodypartcontainsbodypart	concept_braintissue_salivary_glands
concept_airport_split	concept:proxyfor	concept_filmfestival_croatia
concept_physiologicalcondition_crv	concept:atdate	concept_dateliteral_n2008
concept_beverage_soymilk	concept:beveragemadefrombeverage	concept_beverage_juice
concept_televisionshow_prime_time	concept:proxyfor	concept_book_new
concept_hallwayitem_body	concept:subpartof	concept_visualizablething_fluids
concept_agriculturalproduct_crops	concept:agriculturalproductincludingagriculturalproduct	concept_agriculturalproduct_flax
concept_terroristorganization_state	concept:agentcontrols	concept_politicianus_groups
concept_videogame_artist	concept:proxyfor	concept_book_new
concept_company_new_york	concept:competeswith	concept_website_new_york_law_journal
concept_braintissue_patients	concept:bodypartcontainsbodypart	concept_bodypart_cells001
concept_wine_sancerre	concept:beveragemadefrombeverage	concept_wine_pinot
concept_agriculturalproduct_leaks	concept:subpartof	concept_weatherphenomenon_water
concept_musicalbum_icon	concept:proxyfor	concept_weatherphenomenon_new
concept_agriculturalproduct_products	concept:agriculturalproductincludingagriculturalproduct	concept_food_milk_powder
concept_televisionstation_ktsf_tv	concept:agentcollaborateswithagent	concept_athlete_ind
concept_company_ticketmaster	concept:acquired	concept_company_ticketsnow
concept_city_olympic_valley	concept:proxyfor	concept_stateorprovince_california
concept_city_foster_city	concept:mutualproxyfor	concept_stateorprovince_california
concept_recordlabel_r_c_a_	concept:proxyfor	concept_book_new
concept_ceo_page_content	concept:agentcompeteswithagent	concept_personcanada_search
concept_politicsissue_privatization	concept:atdate	concept_date_n2003
concept_sportsteam_state_university	concept:teamalsoknownas	concept_sportsteam_texas_tech_university
concept_protein_hud	concept:atdate	concept_date_n2001
concept_academicfield_technology	concept:academicfieldsuchasacademicfield	concept_academicfield_urban_planning
concept_buildingfeature_shop	concept:subpartof	concept_weatherphenomenon_water
concept_company_nokia	concept:acquired	concept_company_plazes
concept_geopoliticallocation_lse	concept:atdate	concept_dateliteral_n2007
concept_river_schuylkill	concept:riveremptiesintoriver	concept_river_delaware_river
concept_city_article	concept:agentcompeteswithagent	concept_politicalparty_navigation_search
concept_county_chrysler	concept:subpartof	concept_automobilemaker_daimler_benz
concept_ceo_neville_isdell	concept:mutualproxyfor	concept_retailstore_coca_cola
concept_writer_guide	concept:agentcompeteswithagent	concept_tradeunion_search
concept_politicianus_projects	concept:agentcompeteswithagent	concept_personcanada_search
concept_newspaper_kotv	concept:subpartof	concept_website_cbs
concept_mediatype_founder	concept:proxyfor	concept_book_new
concept_city_place	concept:atdate	concept_year_n1856
concept_stateorprovince_bangui	concept:proxyfor	concept_sportsteamposition_central_african_republic
concept_room_benefits	concept:subpartof	concept_weatherphenomenon_water
concept_chemical_water	concept:chemicalistypeofchemical	concept_chemical_sludge
concept_academicfield_science	concept:academicfieldsuchasacademicfield	concept_academicfield_social_science
concept_radiostation_wtaj	concept:subpartof	concept_website_cbs
concept_city_seaford	concept:atlocation	concept_stateorprovince_delaware
concept_bodypart_blood	concept:bodypartcontainsbodypart	concept_nerve_elbow
concept_boardgame_landscapes	concept:proxyfor	concept_book_new
concept_academicfield_communities	concept:subpartof	concept_weatherphenomenon_water
concept_mlauthor_alan_schwartz	concept:proxyfor	concept_retailstore_bear_stearns
concept_river_tonle_sap	concept:riveremptiesintoriver	concept_river_mekong_river
concept_profession_staff	concept:professionistypeofprofession	concept_profession_software_developers
concept_lake_new	concept:locationlocatedwithinlocation	concept_transportation_gp_7
concept_company_oracle	concept:acquired	concept_company_siebel
concept_university_liverpool_john_moores_university	concept:subpartof	concept_geopoliticallocation_fa
concept_chemical_water	concept:chemicalistypeofchemical	concept_chemical_purity
concept_televisionstation_kccw_tv	concept:subpartof	concept_website_cbs
concept_city_greer	concept:atlocation	concept_stateorprovince_south_carolina
concept_televisionstation_kode	concept:subpartof	concept_website_abc
concept_city_glen_cove	concept:atlocation	concept_stateorprovince_new_york
concept_musicartist_cramps	concept:agentcollaborateswithagent	concept_actor_lux_interior
concept_beverage_new	concept:atlocation	concept_landscapefeatures_run
concept_attraction_long_island_city	concept:proxyfor	concept_book_new
concept_city_kettering	concept:atlocation	concept_stateorprovince_ohio
concept_visualizablething_shillong	concept:proxyfor	concept_stateorprovince_meghalaya
concept_company_choicepoint	concept:subpartof	concept_ceo_derek_v__smith
concept_nonprofitorganization_investigations	concept:atdate	concept_date_n2004
concept_lake_new	concept:locationlocatedwithinlocation	concept_website_call
concept_mediatype_special_collections	concept:atdate	concept_date_n2000
concept_website_may_2006	concept:proxyfor	concept_book_new
concept_city_texas	concept:atdate	concept_year_n1835
concept_jobposition_superintendent	concept:subpartof	concept_weatherphenomenon_water
concept_weapon_national	concept:atlocation	concept_city_rowland_heights
concept_sportsteam_uc_davis	concept:atlocation	concept_city_sacramento
concept_beverage_herbal_tea	concept:beveragemadefrombeverage	concept_beverage_juice
concept_city_raleigh_durham_chapel_hill	concept:locationlocatedwithinlocation	concept_stateorprovince_north_carolina
concept_politicianus_ensign	concept:politicianusendorsedbypoliticianus	concept_politicianus_john_ensign
concept_televisionstation_wfmz_tv	concept:agentcollaborateswithagent	concept_athlete_ind
concept_weapon_national	concept:atlocation	concept_city_encino
concept_book_michael	concept:atdate	concept_dateliteral_n2006
concept_animal_links	concept:specializationof	concept_animal_classifieds
concept_sportsteam_state_university	concept:teamalsoknownas	concept_sportsteam_virginia_commonwealth_university
concept_protein_iso	concept:proxyfor	concept_book_new
concept_ceo_alan_mulally	concept:proxyfor	concept_company_ford_motor_company001
concept_invertebrate_larvae	concept:animalthatfeedoninsect	concept_insect_dragonfly
concept_wine_bordeaux_grapes	concept:beveragemadefrombeverage	concept_wine_sauvignon
concept_book_pleasantville	concept:mutualproxyfor	concept_radiostation_new_jersey
concept_televisionstation_kwch_tv	concept:subpartof	concept_website_cbs
concept_city_centerville	concept:atlocation	concept_stateorprovince_ohio
concept_sportsteam_norfolk_state_spartans	concept:agentcollaborateswithagent	concept_personmexico_ncaa
concept_programminglanguage_host	concept:proxyfor	concept_book_new
concept_transportation_firstgroup	concept:subpartof	concept_personsouthamerica_martin_gilbert
concept_river_french_broad	concept:riveremptiesintoriver	concept_river_tennessee_river
concept_charactertrait_effective	concept:atdate	concept_dateliteral_n2007
concept_physicsterm_solution	concept:proxyfor	concept_book_new
concept_date_production	concept:proxyfor	concept_beverage_new
concept_sportsteam_georgia_tech	concept:agentcollaborateswithagent	concept_personmexico_ncaa
concept_televisionshow_first_person	concept:proxyfor	concept_book_new
concept_lake_new	concept:locationlocatedwithinlocation	concept_geopoliticalorganization_grant
concept_election_vanguard	concept:mutualproxyfor	concept_politicianus_john_bogle
concept_city_lansdale	concept:proxyfor	concept_stateorprovince_pennsylvania
concept_profession_essex	concept:atdate	concept_dateliteral_n2006
concept_cognitiveactions_improvement	concept:subpartof	concept_weatherphenomenon_water
concept_musicartist_jungle	concept:proxyfor	concept_book_new
concept_buildingfeature_landslide	concept:atdate	concept_dateliteral_n2005
concept_beverage_cranberry_juice	concept:beveragemadefrombeverage	concept_beverage_juice
concept_person_taylor	concept:agentcontrols	concept_ceo_richard_bowen
concept_perceptionaction_program_manager	concept:atdate	concept_date_n2003
concept_athlete_anna_kournikova	concept:athletebeatathlete	concept_athlete_williams
concept_musicgenre_synth_pop	concept:musicgenressuchasmusicgenres	concept_musicgenre_rock
concept_city_stalingrad	concept:cityalsoknownas	concept_city_volgograd
concept_island_sanibel	concept:atlocation	concept_city_florida
concept_bodypart_thin_membrane	concept:bodypartcontainsbodypart	concept_nerve_spinal_cord
concept_politicalparty_u_s__government	concept:atdate	concept_date_n2003
concept_city_norwood	concept:proxyfor	concept_stateorprovince_massachusetts
concept_skiarea_chicopee	concept:subpartof	concept_beach_massachusetts
concept_ceo_supervalu_inc	concept:subpartof	concept_ceo_jeff_noddle
concept_county_wingate	concept:atlocation	concept_stateorprovince_north_carolina
concept_governmentorganization_government	concept:agentcontrols	concept_male_ideas
concept_city_guwahati	concept:proxyfor	concept_stateorprovince_assam
concept_female_muses	concept:parentofperson	concept_female_mnemosyne
concept_city_crystal	concept:atlocation	concept_stateorprovince_minnesota
concept_scientificterm_linear_transformations_as_matrices	concept:conceptprerequisiteof	concept_scientificterm_change_of_basis
concept_emotion_child	concept:mutualproxyfor	concept_book_new
concept_programminglanguage_questions	concept:specializationof	concept_programminglanguage_page
concept_male_last_adam	concept:parentofperson	concept_person_jesus
concept_ethnicgroup_same_way	concept:proxyfor	concept_book_new
concept_drug_insulin	concept:chemicalistypeofchemical	concept_drug_hormones
concept_company_qualcomm	concept:acquired	concept_company_snaptrack
concept_televisionstation_ashland	concept:subpartof	concept_politicsissue_oregon
concept_mldataset_deere	concept:mutualproxyfor	concept_athlete_sam_allen
concept_musicinstrument_broadway	concept:atlocation	concept_building_vegas
concept_female_argus	concept:parentofperson	concept_female_niobe
concept_sportsteam_hartford_hawks	concept:agentcollaborateswithagent	concept_personmexico_ncaa
concept_politicalparty_continental_congress	concept:proxyfor	concept_emotion_new
concept_musician_the_allman_brothers_band	concept:agentcollaborateswithagent	concept_musicartist_duane_allman_and_dickey_betts
concept_date_top	concept:proxyfor	concept_beverage_new
concept_governmentorganization_centers	concept:mutualproxyfor	concept_politicaloffice_new
concept_televisionnetwork_cbs	concept:agentcontrols	concept_personcanada_ed_bradley
concept_city_gardendale	concept:atlocation	concept_stateorprovince_alabama
concept_lake_new	concept:locationlocatedwithinlocation	concept_restaurant_one_stop_shop
concept_sportsteam_bruins	concept:teamalsoknownas	concept_sportsteam_ucla
concept_bank_wells_fargo	concept:acquired	concept_bank_first_security
concept_automobilemodel_swap	concept:synonymfor	concept_website_add
concept_plant_blossom	concept:plantgrowinginplant	concept_visualizablething_tree
concept_mlsoftware_debian	concept:synonymfor	concept_televisionshow_birthday
concept_bird_pheasants	concept:animalistypeofanimal	concept_bird_upland_game_birds
concept_city_lindenwold	concept:proxyfor	concept_stateorprovince_new_jersey
concept_agriculturalproduct_products	concept:agriculturalproductincludingagriculturalproduct	concept_visualizableobject_pastas
concept_academicfield_science	concept:academicfieldsuchasacademicfield	concept_academicfield_computer_systems
concept_winery_bell	concept:acquired	concept_creditunion_giro
concept_stateorprovince_california	concept:mutualproxyfor	concept_city_marina
concept_city_goodland	concept:proxyfor	concept_creditunion_kansas
concept_city_fieldsboro	concept:proxyfor	concept_stateorprovince_new_jersey
concept_museum_organizations	concept:proxyfor	concept_book_new
concept_city_london_city	concept:atdate	concept_year_n1847
concept_company_dc	concept:competeswith	concept_company_upi
concept_academicfield_mill	concept:atdate	concept_dateliteral_n2006
concept_mountain_mount_ephraim	concept:mutualproxyfor	concept_stateorprovince_new_jersey
concept_televisionstation_ktnc_tv	concept:subpartof	concept_drug_azt
concept_male_ali	concept:fatherofperson	concept_person_hassan
concept_academicfield_technology	concept:academicfieldsuchasacademicfield	concept_academicfield_bsc
concept_buildingfeature_american	concept:atlocation	concept_city_fort_shafter
concept_company_new_york	concept:competeswith	concept_company_slate__com
concept_female_yankees	concept:agentcollaborateswithagent	concept_celebrity_ian_kennedy
concept_geopoliticallocation_kariba	concept:locationlocatedwithinlocation	concept_country_zimbabwe
concept_island_okeechobee	concept:proxyfor	concept_city_florida
concept_personmexico_julian_javier	concept:parentofperson	concept_personus_stan_javier
concept_televisionstation_ksgw_tv	concept:subpartof	concept_website_abc
concept_sportsteam_huskers	concept:teamalsoknownas	concept_sportsteam_state_university
concept_bedroomitem_national_television	concept:atdate	concept_dateliteral_n2006
concept_personmexico_ncaa	concept:agentcontrols	concept_sportsteam_wake_forest_demon_deacons
concept_city_home	concept:agentcompeteswithagent	concept_personcanada_site_search
concept_building_university_of_virginia	concept:mutualproxyfor	concept_person_walter_sheldon_rodman
concept_televisionstation_wfts	concept:subpartof	concept_website_abc
concept_beverage_tequila	concept:beveragemadefrombeverage	concept_beverage_juice
concept_magazine_intuit	concept:agentcollaborateswithagent	concept_journalist_stephen_bennett
concept_personasia_rakesh_roshan	concept:fatherofperson	concept_personafrica_hrithik_roshan
concept_chemical_water	concept:chemicalistypeofchemical	concept_drug_doxycycline
concept_profession_nannies	concept:professionistypeofprofession	concept_profession_professionals
concept_geometricshape_education	concept:subpartof	concept_weatherphenomenon_water
concept_governmentorganization_exchange_commission	concept:atdate	concept_dateliteral_n2006
concept_animal_amazons	concept:animalistypeofanimal	concept_bird_parrots
concept_agriculturalproduct_milk_products	concept:agriculturalproductincludingagriculturalproduct	concept_beverage_milk
concept_city_italy_rome	concept:locationlocatedwithinlocation	concept_country_italy
concept_food_fats	concept:agriculturalproductincludingagriculturalproduct	concept_visualizablething_avocados
concept_academicfield_science	concept:academicfieldsuchasacademicfield	concept_academicfield_broadcast_journalism
concept_company_yahoo001	concept:competeswith	concept_automobilemaker_video
concept_city_randolph	concept:proxyfor	concept_stateorprovince_new_jersey
concept_city_green_valley	concept:atlocation	concept_stateorprovince_arizona
concept_male_saturn	concept:fatherofperson	concept_male_uranus
concept_agriculturalproduct_grains	concept:agriculturalproductincludingagriculturalproduct	concept_grain_bulgur_wheat
concept_bodypart_atrium	concept:bodypartcontainsbodypart	concept_artery_left_atrium
concept_emotion_bars	concept:mutualproxyfor	concept_book_new
concept_male_cecil_fielder	concept:fatherofperson	concept_person_prince_fielder
concept_city_san_carlos	concept:atlocation	concept_stateorprovince_california
concept_company_arcelor_mittal	concept:acquired	concept_biotechcompany_arcelor
concept_televisionshow_black_entertainment_television	concept:mutualproxyfor	concept_transportation_robert_johnson
concept_person_rice	concept:agentcontrols	concept_coach_david_bailiff
concept_militaryconflict_eastern_front	concept:atdate	concept_dateliteral_n1943
concept_vertebrate_herds	concept:ismultipleof	concept_animal_yak
concept_river_nile	concept:riveremptiesintoriver	concept_river_lake_nasser
concept_emotion_personnel	concept:mutualproxyfor	concept_book_new
concept_televisionstation_wbtv	concept:subpartof	concept_website_cbs
concept_county_st__george	concept:atlocation	concept_county_utah
concept_city_krasnojarsk	concept:locationlocatedwithinlocation	concept_country_russia
concept_county_los_angeles_county	concept:cityalsoknownas	concept_city_l_a
concept_placeofworship_wallington	concept:proxyfor	concept_stateorprovince_new_jersey
concept_televisionstation_wftv	concept:subpartof	concept_website_abc
concept_skiarea_ringwood	concept:proxyfor	concept_radiostation_new_jersey
concept_academicfield_biology	concept:academicfieldsuchasacademicfield	concept_academicfield_human_biology
concept_coach_philip_fulmer	concept:subpartof	concept_astronaut_vols
concept_charactertrait_relatives	concept:proxyfor	concept_book_new
concept_profession_guides	concept:professionistypeofprofession	concept_profession_naturalists
concept_chemical_water	concept:chemicalistypeofchemical	concept_drug_sodium_chloride
concept_county_staunton	concept:atlocation	concept_stateorprovince_virginia
concept_agriculturalproduct_grains	concept:agriculturalproductincludingagriculturalproduct	concept_agriculturalproduct_lentils
concept_musicalbum_favorites	concept:proxyfor	concept_weatherphenomenon_new
concept_jobposition_nurse	concept:professionistypeofprofession	concept_jobposition_manager
concept_city_chatham_kent	concept:proxyfor	concept_stateorprovince_ontario
concept_wallitem_problems	concept:mutualproxyfor	concept_book_new
concept_personnorthamerica_wits	concept:subpartof	concept_website_blood
concept_conference_wage	concept:atdate	concept_dateliteral_n2008
concept_city_ogallala	concept:atlocation	concept_stateorprovince_nebraska
concept_lake_bass_lake	concept:atlocation	concept_stateorprovince_california
concept_musician_bee_gees	concept:agentcollaborateswithagent	concept_personus_barry_gibb
concept_governmentorganization_nice	concept:atdate	concept_dateliteral_n2006
concept_biotechcompany_health_canada	concept:atdate	concept_date_n2004
concept_insect_earthworms	concept:animalistypeofanimal	concept_invertebrate_annelids
concept_school_wasilla_high_school	concept:agentcollaborateswithagent	concept_person_levi_johnston
concept_county_bowman	concept:atlocation	concept_stateorprovince_north_dakota
concept_sportsteam_north_alabama_lions	concept:agentcollaborateswithagent	concept_personmexico_ncaa
concept_governmentorganization_communities_and_local_government	concept:atdate	concept_dateliteral_n2007
concept_room_community	concept:subpartof	concept_weapon_propane
concept_river_ganges	concept:riveremptiesintoriver	concept_river_bay_of_bengal
concept_city_savannah	concept:proxyfor	concept_stateorprovince_georgia
concept_animal_serpents	concept:animalpreyson	concept_animal_creatures
concept_biotechcompany_procter___gamble	concept:acquired	concept_company_gillette
concept_automobilemaker_honda_motor_company	concept:agentcontrols	concept_musicartist_takeo_fukui
concept_city_kristiansund	concept:locationlocatedwithinlocation	concept_country_norway
concept_website_western_new_york	concept:proxyfor	concept_book_new
concept_company_new_york	concept:competeswith	concept_televisionstation_dallas_morning_news
concept_bedroomitem_system	concept:subpartof	concept_transportation_full_air
concept_sportsteam_texas_tyler_patriots	concept:agentcollaborateswithagent	concept_personmexico_ncaa
concept_everypromotedthing_city_of_brotherly_love	concept:synonymfor	concept_male_philadelphia
concept_bodypart_blood	concept:bodypartcontainsbodypart	concept_artery_portal_vein
concept_company_bp001	concept:mutualproxyfor	concept_personcanada_tony_hayward
concept_visualizablething_dwelling	concept:subpartof	concept_weatherphenomenon_water
concept_lake_new	concept:locationlocatedwithinlocation	concept_landscapefeatures_view
concept_braintissue_adult_rat	concept:bodypartcontainsbodypart	concept_bodypart_cells001
concept_person_tamar	concept:parentofperson	concept_writer_perez
concept_professionalorganization_elks	concept:agentcompeteswithagent	concept_animal_animals002
concept_vehicle_government_agencies	concept:proxyfor	concept_book_new
concept_scientificterm_basis_function_expansions	concept:conceptprerequisiteof	concept_scientificterm_feed_forward_neural_nets
concept_website_gigablast	concept:agentcompeteswithagent	concept_university_search
concept_buildingfeature_certificates	concept:subpartof	concept_weatherphenomenon_water
concept_weapon_national	concept:atlocation	concept_park_kingston
concept_geopoliticallocation_calumet	concept:proxyfor	concept_creditunion_michigan
concept_automobilemaker_bmw	concept:competeswith	concept_automobilemaker_daimler
concept_software_vmware	concept:subpartof	concept_musicartist_emc
concept_jobposition_form	concept:proxyfor	concept_book_new
concept_automobilemaker_gm	concept:acquired	concept_automobilemaker_gmc
concept_visualizablething_triangle	concept:thinghasshape	concept_geometricshape_altitudes
concept_beverage_iced_tea	concept:beveragemadefrombeverage	concept_beverage_juice
concept_island_tasmania	concept:atdate	concept_date_n2004
concept_company_nbc	concept:agentcontrols	concept_blog_wsls
concept_buildingfeature_security	concept:subpartof	concept_weatherphenomenon_water
concept_bank_j_p__morgan___co_	concept:acquired	concept_biotechcompany_bank_of_montreal
concept_athlete_nick_faldo	concept:athletebeatathlete	concept_athlete_greg_norman
concept_city_providence	concept:proxyfor	concept_stateorprovince_rhodeisland
concept_musicartist_big_deal	concept:proxyfor	concept_book_new
concept_city_memphis	concept:locationlocatedwithinlocation	concept_stateorprovince_tennessee
concept_profession_videographers	concept:professionistypeofprofession	concept_profession_professionals
concept_company_dc	concept:competeswith	concept_website_washington_star
concept_website_overstock	concept:agentcollaborateswithagent	concept_personus_patrick_byrne
concept_everypromotedthing_n0_error	concept:synonymfor	concept_musicalbum_exist
concept_river_san_joaquin	concept:riveremptiesintoriver	concept_geopoliticallocation_delta
concept_sportsteam_bloomsburg_huskies	concept:agentcollaborateswithagent	concept_personmexico_ncaa
concept_hobby_markets	concept:proxyfor	concept_book_new
concept_company_addison	concept:atlocation	concept_city_texas
concept_lake_new	concept:locationlocatedwithinlocation	concept_stadiumoreventvenue_intersection
concept_city_kennett	concept:proxyfor	concept_stateorprovince_missouri
concept_personeurope_abigail_adams	concept:parentofperson	concept_personeurope_john_quincy_adams
concept_election_swing_states	concept:proxyfor	concept_book_new
concept_ceo_john_silvester_varley	concept:proxyfor	concept_bank_barclays
concept_skiarea_vernon_valley	concept:mutualproxyfor	concept_radiostation_new_jersey
concept_academicfield_structures	concept:subpartof	concept_weatherphenomenon_water
concept_sportsteam_ncaa_youth_kids	concept:agentcompeteswithagent	concept_bird_northwestern
concept_personaustralia_james_j__greco	concept:agentcontrols	concept_retailstore_bruegger_s
concept_scientificterm_projection_onto_a_subspace	concept:conceptprerequisiteof	concept_scientificterm_linear_least_squares
concept_physicalaction_pregnancy	concept:atdate	concept_dateliteral_n2006
concept_coach_cleveland_cavaliers	concept:atlocation	concept_city_cleveland
concept_male_cornell	concept:agentcontrols	concept_person_noah_snavely
concept_consumerelectronicitem_tablets	concept:subpartof	concept_weatherphenomenon_water
concept_musicartist_american	concept:atlocation	concept_visualizablething_elmhurst
concept_male_world	concept:agentcontrols	concept_candy_john
concept_city_new_orleans	concept:atdate	concept_year_n1815
concept_animal_san_jose	concept:mutualproxyfor	concept_politician_chuck_reed
concept_company_sprint001	concept:organizationalsoknownas	concept_company_sprint_nextel_corp_
concept_city_pueblo	concept:proxyfor	concept_stateorprovince_colorado
concept_wine_auxerrois	concept:beveragemadefrombeverage	concept_wine_pinot
concept_stateorprovince_illinois	concept:mutualproxyfor	concept_city_skokie
concept_biotechcompany_cnet_networks	concept:acquired	concept_blog_zdnet
concept_lake_new	concept:locationlocatedwithinlocation	concept_geopoliticallocation_shopping
concept_biotechcompany_infosys	concept:mutualproxyfor	concept_ceo_kris_gopalakrishnan
concept_city_lhasa	concept:proxyfor	concept_agent_tibet
concept_city_bloomingdale	concept:proxyfor	concept_stateorprovince_newjersey
concept_sportsteam_state_university	concept:teamalsoknownas	concept_sportsteam_eastern_kentucky_university
concept_beverage_dispute	concept:atdate	concept_dateliteral_n2007
concept_beverage_calvados	concept:beveragemadefrombeverage	concept_beverage_juice
concept_company_pbs	concept:agentcontrols	concept_televisionstation_wlae_tv
concept_invertebrate_bivalves	concept:animalsuchasinvertebrate	concept_arthropod_mussels
concept_profession_staff	concept:professionistypeofprofession	concept_profession_certified_professionals
concept_physicalcharacteristic_treatment_service	concept:subpartof	concept_weatherphenomenon_water
concept_city_las_palmas_de_gran_canaria	concept:locationlocatedwithinlocation	concept_visualizablething_gran_canaria
concept_male_zeus	concept:hassibling	concept_female_poseidon
concept_beverage_distilled_water	concept:beveragemadefrombeverage	concept_beverage_juice
concept_book_new	concept:mutualproxyfor	concept_buildingfeature_host
concept_lake_new	concept:locationlocatedwithinlocation	concept_retailstore_guides
concept_stadiumoreventvenue_chastain_park_amphitheatre	concept:atlocation	concept_county_atlanta
concept_city_morganton	concept:locationlocatedwithinlocation	concept_stateorprovince_north_carolina
concept_company_amd	concept:acquired	concept_company_ati
concept_island_summerfield	concept:atlocation	concept_city_florida
concept_academicfield_biology	concept:academicfieldsuchasacademicfield	concept_politicsissue_environment
concept_plant_white_blossoms	concept:plantgrowinginplant	concept_visualizablething_tree
concept_city_newport	concept:atlocation	concept_stateorprovince_oregon
concept_musicinstrument_bass	concept:atdate	concept_dateliteral_n2002
concept_attraction_mississippi	concept:riveremptiesintoriver	concept_river_rum_river
concept_male_abraham	concept:fatherofperson	concept_male_midian
concept_bathroomitem_creative	concept:subpartof	concept_person_robin_bronk
concept_biotechcompany_novell	concept:acquired	concept_company_suse
concept_personmexico_ncaa	concept:agentcontrols	concept_sportsteam_wayne_state_warriors
concept_university_morgan_state	concept:atlocation	concept_county_baltimore
concept_city_mckeesport	concept:atlocation	concept_stateorprovince_pennsylvania
concept_chemical_water	concept:chemicalistypeofchemical	concept_chemical_saline
concept_bodypart_system002	concept:bodypartcontainsbodypart	concept_braintissue_sensory_systems
concept_musicgenre_post_rock	concept:musicgenressuchasmusicgenres	concept_musicgenre_rock
concept_river_columbia	concept:riveremptiesintoriver	concept_river_west_coast
concept_profession_name	concept:specializationof	concept_profession_information
concept_county_seattle	concept:proxyfor	concept_skyscraper_moore_theatre
concept_televisionshow_regina	concept:atdate	concept_dateliteral_n2006
concept_sport_management_services	concept:subpartof	concept_weatherphenomenon_water
concept_geopoliticallocation_dodgeville	concept:proxyfor	concept_politicaloffice_wisconsin
concept_vertebrate_herds	concept:ismultipleof	concept_mammal_springbok
concept_artery_arterial_blood	concept:bodypartcontainsbodypart	concept_lymphnode_rate
concept_politicsblog_real_estate	concept:competeswith	concept_blog_realtor_com
concept_date_contact	concept:proxyfor	concept_beverage_new
concept_farm_waltham_fields_community_farm	concept:subpartof	concept_visualizablescene_united_state
concept_stateorprovince_agartala	concept:proxyfor	concept_ethnicgroup_tripura
concept_scientificterm_student_t_distribution	concept:conceptprerequisiteof	concept_scientificterm_comparing_normal_populations
concept_sportsteam_ncaa_youth_kids	concept:agentcontrols	concept_musicfestival_virginia_cavaliers
concept_skiarea_helena	concept:proxyfor	concept_radiostation_montana
concept_city_kuwait_city	concept:locationlocatedwithinlocation	concept_country_kuwait
concept_sociopolitical_terrorism	concept:atdate	concept_dateliteral_n2002
concept_stateorprovince_kandy	concept:locationlocatedwithinlocation	concept_country_sri_lanka
concept_politicsblog_tribune	concept:agentcontrols	concept_terroristorganization_le_monde
concept_wine_chardonnays	concept:beveragemadefrombeverage	concept_wine_pinot
concept_book_new	concept:atlocation	concept_island_guinea
concept_city_place	concept:atdate	concept_year_n1815
concept_politicsissue_affairs	concept:synonymfor	concept_academicfield_ministries
concept_politicaloffice_wisconsin	concept:mutualproxyfor	concept_beverage_madison
concept_musicartist_mr_big	concept:agentcollaborateswithagent	concept_musician_paul_gilbert
concept_programminglanguage_system	concept:subpartof	concept_beverage_energy_efficient_water
concept_agriculturalproduct_products	concept:agriculturalproductincludingagriculturalproduct	concept_agriculturalproduct_milks
concept_academicfield_science	concept:academicfieldsuchasacademicfield	concept_academicfield_theoretical_physics
concept_chemical_dioxide	concept:chemicalistypeofchemical	concept_chemical_carbon_atom
concept_bodypart_system001	concept:bodypartcontainsbodypart	concept_bodypart_human_nervous_system
concept_geopoliticalorganization_site_search	concept:agentcompeteswithagent	concept_city_home
concept_musicsong_hurricane	concept:proxyfor	concept_weatherphenomenon_new
concept_company_bharti_telecom	concept:mutualproxyfor	concept_person_sunil_mittal
concept_buildingfeature_sales	concept:subpartof	concept_weatherphenomenon_air
concept_academicfield_technology	concept:academicfieldsuchasacademicfield	concept_academicfield_materials_science_and_engineering
concept_city_easley	concept:atlocation	concept_stateorprovince_south_carolina
concept_river_columbia	concept:riveremptiesintoriver	concept_river_mount_hood
concept_museum_rockland	concept:atlocation	concept_skiarea_maine
concept_newspaper_wavy_tv	concept:subpartof	concept_retailstore_nbc
concept_emotion_fields	concept:proxyfor	concept_book_new
concept_river_columbia	concept:riveremptiesintoriver	concept_skiarea_columbia_basin
concept_male_darryl_strawberry	concept:fatherofperson	concept_person_d_j__strawberry
concept_city_norwood	concept:locationlocatedwithinlocation	concept_stateorprovince_massachusetts
concept_city_west_hartford	concept:atlocation	concept_stateorprovince_connecticut
concept_lake_new	concept:locationlocatedwithinlocation	concept_website_pilot
concept_lake_new	concept:locationlocatedwithinlocation	concept_landscapefeatures_scenery
concept_sportsteam_east_tennessee_state_lady_buccaneers	concept:agentcollaborateswithagent	concept_personmexico_ncaa
concept_date_level	concept:proxyfor	concept_beverage_new
concept_female_yankees	concept:agentcollaborateswithagent	concept_personus_bernie_williams
concept_city_lindenwold	concept:proxyfor	concept_stateorprovince_newjersey
concept_university_nottingham	concept:atdate	concept_date_n2009
concept_biotechcompany_salesforce_com	concept:mutualproxyfor	concept_ceo_marc_benioff
concept_person_barry	concept:atlocation	concept_city_orlando
concept_visualizablething_kuala_terengganu	concept:locationlocatedwithinlocation	concept_country_malaysia
concept_tradeunion_search	concept:agentcompeteswithagent	concept_recordlabel_release
concept_vertebrate_summer	concept:mutualproxyfor	concept_book_new
concept_academicfield_health_sciences	concept:atdate	concept_dateliteral_n2007
concept_bodypart_blood	concept:bodypartcontainsbodypart	concept_artery_lower_extremity
concept_university_state_university	concept:organizationalsoknownas	concept_university_bowling_green_state
concept_room_systems	concept:subpartof	concept_buildingfeature_storm_drainage
concept_company_nbc	concept:agentcontrols	concept_televisionstation_ksnt_tv
concept_city_khe_sanh	concept:atdate	concept_date_n1968
concept_highway_niagara_falls	concept:mutualproxyfor	concept_company_new_york
concept_lake_new	concept:locationlocatedwithinlocation	concept_attraction_vacations
concept_televisionstation_kmvt	concept:subpartof	concept_website_cbs
concept_currency_southeast	concept:proxyfor	concept_book_new
concept_weapon_national	concept:atlocation	concept_city_ahwahnee
concept_beverage_limeade	concept:beveragemadefrombeverage	concept_beverage_juice
concept_braintissue_rabbit	concept:bodypartcontainsbodypart	concept_bodypart_cells001
concept_chemical_hydrocarbons	concept:chemicalistypeofchemical	concept_chemical_carcinogenic_substances
concept_biotechcompany_hilton_hotels	concept:subpartof	concept_ceo_stephen_bollenbach
concept_televisionstation_wgba	concept:subpartof	concept_retailstore_nbc
concept_weatherphenomenon_n30_years	concept:proxyfor	concept_book_new
concept_weapon_national	concept:atlocation	concept_city_barataria
concept_blog_google	concept:acquired	concept_website_writely
concept_programminglanguage_system	concept:subpartof	concept_beverage_internal_water
concept_agent_linux	concept:synonymfor	concept_currency_lemp
concept_stateorprovince_johnson	concept:atdate	concept_dateliteral_n2005
concept_profession_senior_executives	concept:professionistypeofprofession	concept_profession_experts
concept_weapon_national	concept:atlocation	concept_city_universal_city
concept_physicsterm_mix	concept:proxyfor	concept_book_new
concept_profession_account_managers	concept:professionistypeofprofession	concept_profession_professionals
concept_profession_coordinators	concept:professionistypeofprofession	concept_profession_professionals
concept_visualizablething_distiller	concept:synonymfor	concept_website_adobe
concept_book_blessing	concept:proxyfor	concept_eventoutcome_new
concept_chemical_dioxide	concept:chemicalistypeofchemical	concept_chemical_important_greenhouse_gases
concept_physicalaction_removal	concept:subpartof	concept_weatherphenomenon_water
concept_mlmetric_n15__	concept:proxyfor	concept_book_new
concept_profession_professionals	concept:professionistypeofprofession	concept_profession_medical_technicians
concept_landscapefeatures_states	concept:locationlocatedwithinlocation	concept_aquarium_east_coast
concept_company_crowd	concept:proxyfor	concept_book_new
concept_island_charlie	concept:atdate	concept_dateliteral_n2007
concept_politicianus_mccain	concept:politicianusendorsedbypoliticianus	concept_politicianus_alaska_governor_sarah_palin
concept_videogame_caesars_palace	concept:subpartof	concept_traditionalgame_vegas
concept_profession_staff	concept:professionistypeofprofession	concept_profession_travel_professionals
concept_mediatype_restructuring	concept:atdate	concept_dateliteral_n2008
concept_river_schuylkill	concept:riveremptiesintoriver	concept_river_wissahickon_creek
concept_city_doylestown	concept:atlocation	concept_stateorprovince_pennsylvania
concept_university_baruch_college	concept:atlocation	concept_island_new_york_city_metropolitan_area
concept_river_clackamas_river	concept:riveremptiesintoriver	concept_river_willamette_river
concept_householditem_english	concept:proxyfor	concept_book_new
concept_beach_fort_pierce	concept:locationlocatedwithinlocation	concept_city_florida
concept_lake_new	concept:locationlocatedwithinlocation	concept_transportation_control
concept_company_owens_corning	concept:subpartof	concept_ceo_david_brown
concept_county_east_point	concept:atlocation	concept_stateorprovince_georgia
concept_male_david_miller	concept:atlocation	concept_city_toronto
concept_boardgame_u_n__security_council	concept:mutualproxyfor	concept_person_iran
concept_female_yankees	concept:agentcompeteswithagent	concept_person_twins
concept_politicalparty_three_states	concept:proxyfor	concept_emotion_new
concept_beverage_solution	concept:beveragemadefrombeverage	concept_beverage_juice
concept_mlmetric_number_four	concept:proxyfor	concept_book_new
concept_transportation_conference_call	concept:atdate	concept_dateliteral_n2007
concept_emotion_opposition	concept:atdate	concept_date_n2003
concept_televisionstation_kiku	concept:agentcollaborateswithagent	concept_athlete_ind
concept_chemical_ammonia	concept:chemicalistypeofchemical	concept_chemical_refrigerants
concept_city_cottage_grove	concept:proxyfor	concept_stateorprovince_minnesota
concept_city_cherry_hill	concept:proxyfor	concept_stateorprovince_newjersey
concept_sportsteam_ncaa_youth_kids	concept:agentcompeteswithagent	concept_sportsteam_georgia_tech
concept_beverage_white_wine_vinegar	concept:beveragemadefrombeverage	concept_beverage_juice
concept_city_sidney	concept:atlocation	concept_stateorprovince_ohio
concept_weapon_national	concept:atlocation	concept_city_north_hills
concept_mammal_koala	concept:mammalsuchasmammal	concept_mammal_marsupials
concept_politicianus_sununu	concept:politicianusendorsedbypoliticianus	concept_politicianus_john_sununu
concept_city_phuket	concept:atdate	concept_dateliteral_n2005
concept_landscapefeatures_des_moines_register	concept:mutualproxyfor	concept_journalist_randy_peterson
concept_company_emc001	concept:acquired	concept_company_mozy
concept_city_flemingsburg	concept:proxyfor	concept_coach_kentucky
concept_buildingfeature_host	concept:mutualproxyfor	concept_book_new
concept_sportsteam_arizona_state_sun_devils	concept:agentcollaborateswithagent	concept_personmexico_ncaa
concept_plant_tropical_flowers	concept:plantgrowinginplant	concept_plant_trees
concept_beach_st_augustine	concept:atlocation	concept_city_florida
concept_politicalparty_navigation_search	concept:agentcompeteswithagent	concept_website_article
concept_televisionstation_wtvr_tv	concept:subpartof	concept_website_cbs
concept_beverage_new	concept:atlocation	concept_attraction_mouth
concept_vehicle_height	concept:thinghasshape	concept_geometricshape_triangle
concept_profession_partnership	concept:professionistypeofprofession	concept_profession_leaders
concept_blog_google	concept:acquired	concept_company_deja
concept_sportsteam_reedley_college_tigers	concept:agentcollaborateswithagent	concept_personmexico_ncaa
concept_lake_new	concept:locationlocatedwithinlocation	concept_visualizablescene_visitors
concept_hotel_carlyle	concept:locationlocatedwithinlocation	concept_island_new_york_city_metropolitan_area
concept_retailstore_canon	concept:mutualproxyfor	concept_ceo_fujio_mitarai
concept_professionalorganization_summit	concept:agentcontrols	concept_person_mugabe
concept_celebrity_milton	concept:atlocation	concept_city_florida
concept_city_birmingham	concept:proxyfor	concept_stadiumoreventvenue_bjcc_concert_hall
concept_nonprofitorganization_force	concept:proxyfor	concept_book_new
concept_academicfield_sciences	concept:academicfieldsuchasacademicfield	concept_academicfield_physical
concept_criminal_gentlemen	concept:ismultipleof	concept_criminal_gentleman
concept_mldataset_safe	concept:proxyfor	concept_book_new
concept_consumerelectronicitem_ms_word	concept:mutualproxyfor	concept_university_microsoft
concept_celebrity_babies	concept:agentcompeteswithagent	concept_animal_animals001
concept_company_nbc	concept:agentcollaborateswithagent	concept_journalist_chet_huntley
concept_company_new_york	concept:competeswith	concept_newspaper_msnbc_com
concept_sportsteam_butler_bulldogs	concept:agentcollaborateswithagent	concept_personmexico_ncaa
concept_televisionstation_wsbt	concept:subpartof	concept_website_cbs
concept_university_district_of_columbia	concept:atlocation	concept_city_washington_d_c
concept_jobposition_administrative_assistant	concept:atdate	concept_dateliteral_n2007
concept_city_norfolk	concept:proxyfor	concept_stadiumoreventvenue_constant_convocation_center
concept_televisionstation_wrgb	concept:subpartof	concept_website_cbs
concept_physicsterm_process	concept:proxyfor	concept_book_new
concept_academicfield_bsc	concept:academicfieldsuchasacademicfield	concept_academicfield_engineering
concept_city_lahore	concept:locationlocatedwithinlocation	concept_stateorprovince_punjab
concept_bodypart_system001	concept:bodypartcontainsbodypart	concept_bodypart_thymus
concept_chemical_water	concept:chemicalistypeofchemical	concept_chemical_billion
concept_book_skin	concept:subpartof	concept_website_blood
concept_transportation_tuscaloosa	concept:subpartof	concept_celebrity_alabama
concept_chemical_greenhouse_emissions	concept:chemicalistypeofchemical	concept_chemical_fuels
concept_city_arkadelphia	concept:atlocation	concept_stateorprovince_arkansas
concept_stateorprovince_indiana	concept:agentcontrols	concept_personafrica_mike_davis
concept_bank_osaka	concept:proxyfor	concept_radiostation_japan
concept_book_sahara	concept:subpartof	concept_traditionalgame_vegas
concept_weapon_national	concept:atlocation	concept_visualizablething_elmhurst
concept_person_richard001	concept:agentcontrols	concept_charactertrait_world
concept_televisionstation_wway_tv	concept:subpartof	concept_website_abc
concept_vehicle_il	concept:atdate	concept_dateliteral_n2007
concept_traditionalgame_us_	concept:proxyfor	concept_book_new
concept_musicalbum_pack	concept:proxyfor	concept_weatherphenomenon_new
concept_male_japheth	concept:fatherofperson	concept_person_gomer
concept_city_parma	concept:atlocation	concept_stateorprovince_ohio
concept_city_counterparts	concept:proxyfor	concept_politicaloffice_new
concept_sportsteam_ncaa_youth_kids	concept:agentcompeteswithagent	concept_writer_george_mason
concept_river_shepherdsville	concept:proxyfor	concept_coach_kentucky
concept_invertebrate_lice	concept:specializationof	concept_arthropod_external_parasites
concept_personeurope_theodore_roosevelt	concept:agentcontrols	concept_election_white
concept_sportsteam_lincoln_blue_tigers	concept:agentcollaborateswithagent	concept_personmexico_ncaa
concept_bodypart_system001	concept:bodypartcontainsbodypart	concept_bodypart_inflammatory_response
concept_animal_humans	concept:animalistypeofanimal	concept_vertebrate_warm_blooded_animals
concept_animal_zoanthids	concept:animalistypeofanimal	concept_invertebrate_corals
concept_beverage_light_rum	concept:beveragemadefrombeverage	concept_beverage_juice
concept_televisionshow_compact	concept:atdate	concept_dateliteral_n2007
concept_city_east_ellijay	concept:atlocation	concept_stateorprovince_georgia
concept_city_springfield	concept:atlocation	concept_hotel_old
concept_insect_pests	concept:animalthatfeedoninsect	concept_insect_armyworms
concept_buildingfeature_home	concept:subpartof	concept_beverage_solar_hot_water
concept_musicalbum_hospice	concept:atdate	concept_dayofweek_tuesday
concept_personmexico_ncaa	concept:agentcontrols	concept_sportsteam_troy_university_trojans
concept_city_radcliff	concept:proxyfor	concept_coach_kentucky
concept_scientificterm_convex_functions	concept:conceptprerequisiteof	concept_scientificterm_convex_optimization
concept_lake_florida_keys	concept:proxyfor	concept_book_new
concept_company_general_mills001	concept:agentcollaborateswithagent	concept_magazine_pillsbury
concept_river_lake_champlain	concept:proxyfor	concept_book_new
concept_chemical_water	concept:chemicalistypeofchemical	concept_visualizablething_rock_salt
concept_book_perfect_match	concept:proxyfor	concept_eventoutcome_new
concept_male_tent	concept:subpartof	concept_weatherphenomenon_air
concept_animal_fins	concept:animalsuchasfish	concept_fish_trout
concept_amphibian_losses	concept:atdate	concept_dateliteral_n2008
concept_city_weston	concept:proxyfor	concept_stateorprovince_connecticut
concept_emotion_priest	concept:atdate	concept_dateliteral_n2006
concept_economicsector_advertising	concept:proxyfor	concept_book_new
concept_lake_new	concept:locationlocatedwithinlocation	concept_country_scandinavia
concept_person_mozart	concept:agentcollaborateswithagent	concept_person_john001
concept_placeofworship_wallington	concept:proxyfor	concept_stateorprovince_newjersey
concept_book_observations	concept:atdate	concept_year_n1994
concept_musicartist_longview	concept:atlocation	concept_city_texas
concept_personeurope_amalia	concept:atdate	concept_dayofweek_thursday
concept_city_riga	concept:atdate	concept_dateliteral_n2006
concept_city_abc	concept:agentcontrols	concept_publication_wggb_tv
concept_agriculturalproduct_products	concept:agriculturalproductincludingagriculturalproduct	concept_agriculturalproduct_peanut_butter
concept_bird_flamingoes	concept:animalistypeofanimal	concept_bird_water_birds
concept_televisionstation_wcvn	concept:subpartof	concept_museum_pbs
concept_blog_maryville	concept:proxyfor	concept_weatherphenomenon_tennessee
concept_river_snake	concept:riveremptiesintoriver	concept_river_hells_canyon
concept_parlourgame_n40_minutes	concept:proxyfor	concept_book_new
concept_company_interface	concept:agentcollaborateswithagent	concept_journalist_ray_anderson
concept_book_new	concept:mutualproxyfor	concept_eventoutcome_character
concept_director_meyer	concept:subpartof	concept_university_uf
concept_athlete_vijay_singh	concept:athletebeatathlete	concept_athlete_tiger_woods
concept_coach_vancouver_canucks	concept:agentcontrols	concept_sportsteamposition_roberto_luongo
concept_personus_guillermo_mota	concept:agentcollaborateswithagent	concept_sportsleague_mlb
concept_river_blue_earth_river	concept:riveremptiesintoriver	concept_river_minnesota_river
concept_personcanada_injuries	concept:atdate	concept_date_n2000
concept_televisionshow_me	concept:subpartof	concept_country_usa
concept_scientificterm_projection_onto_a_subspace	concept:conceptprerequisiteof	concept_scientificterm_fisher_s_linear_discriminant
concept_book_new	concept:mutualproxyfor	concept_emotion_favourite
concept_company_pembina_institute	concept:subpartof	concept_person_chris_severson_baker
concept_weapon_national	concept:atlocation	concept_geopoliticallocation_el_toro
concept_chemical_sulfur_trioxide	concept:chemicalistypeofchemical	concept_chemical_sulfur
concept_city_amritsar	concept:proxyfor	concept_stateorprovince_punjab
concept_county_n2_years	concept:proxyfor	concept_coach_new
concept_lake_new	concept:locationlocatedwithinlocation	concept_landscapefeatures_coastlines
concept_disease_hot_spots	concept:proxyfor	concept_book_new
concept_newspaper_new_york_times_company	concept:acquired	concept_company_about_com
concept_buildingfeature_american	concept:atlocation	concept_mountain_arvada
concept_color_crimson_tide	concept:subpartof	concept_sportsteam_ncaa_mens_midwest_regionals
concept_vertebrate_herds	concept:ismultipleof	concept_animal_hippo
concept_personmexico_ncaa	concept:agentcontrols	concept_sportsteam_alaska_anchorage_seawolves
concept_roadaccidentevent_p_m__sunday	concept:atdate	concept_date_community
concept_wine_thompson	concept:proxyfor	concept_stateorprovince_manitoba
concept_buildingfeature_american	concept:atlocation	concept_city_manchaca
concept_musicsong_difficulties	concept:ismultipleof	concept_publication_people_
concept_food_delight	concept:proxyfor	concept_beverage_new
concept_city_mentor	concept:atdate	concept_dateliteral_n2007
concept_person_grand_funk	concept:agentcollaborateswithagent	concept_comedian_don_brewer
concept_city_hornell	concept:atlocation	concept_stateorprovince_new_york
concept_city_searcy	concept:atlocation	concept_stateorprovince_arkansas
concept_reptile_bobcat	concept:agentcompeteswithagent	concept_animal_animals002
concept_sportsteam_state_university	concept:teamalsoknownas	concept_sportsteam_illinois_state_university
concept_city_tullahoma	concept:proxyfor	concept_weatherphenomenon_tennessee
concept_city_kandla	concept:locationlocatedwithinlocation	concept_country_republic_of_india
concept_city_warsaw	concept:mutualproxyfor	concept_person_hanna_gronkiewicz_waltz
concept_city_kota_kinabalu	concept:proxyfor	concept_geopoliticalorganization_sabah
concept_buildingfeature_american	concept:atlocation	concept_city_pearl_harbor
concept_city_kuusamo	concept:locationlocatedwithinlocation	concept_country_finland
concept_personus_part	concept:proxyfor	concept_geopoliticallocation_friendship
concept_cardgame_states_	concept:proxyfor	concept_book_new
concept_mammal_elves	concept:animalistypeofanimal	concept_animal_creatures
concept_stateorprovince_states	concept:stateorprovinceisborderedbystateorprovince	concept_stateorprovince_ns
concept_city_guwahati	concept:locationlocatedwithinlocation	concept_country_republic_of_india
concept_chemical_action	concept:mutualproxyfor	concept_person_mugabe
concept_city_bhagalpur	concept:proxyfor	concept_stateorprovince_bihar
concept_person_cody	concept:atlocation	concept_stateorprovince_wyoming
concept_person_prince	concept:agentcollaborateswithagent	concept_city_john
concept_visualizablething_koh_samui	concept:locationlocatedwithinlocation	concept_country_thailand
concept_county_little_ferry	concept:mutualproxyfor	concept_radiostation_new_jersey
concept_musicalbum_death	concept:atdate	concept_year_n1853
concept_insect_hybrids	concept:animalistypeofanimal	concept_animal_animals001
concept_country_france_france	concept:atdate	concept_year_n1848
concept_jobposition_brigadier_general	concept:atdate	concept_year_n1862
concept_city_melbourne	concept:proxyfor	concept_stadiumoreventvenue_rod_laver_arena
concept_skiarea_plains	concept:proxyfor	concept_book_new
concept_weapon_national	concept:atlocation	concept_city_claymont
concept_wallitem_division	concept:mutualproxyfor	concept_book_new
concept_director_brad_grey	concept:subpartof	concept_televisionshow_paramount_pictures
concept_profession_staff	concept:professionistypeofprofession	concept_profession_graphic_designers
concept_scientificterm_student_t_distribution	concept:conceptprerequisiteof	concept_scientificterm_heavy_tailed_distributions
concept_city_kemi	concept:locationlocatedwithinlocation	concept_country_finland
concept_male_satan	concept:fatherofperson	concept_person_eden
concept_park_north_tampa	concept:atlocation	concept_city_florida
concept_wine_albarino	concept:beveragemadefrombeverage	concept_wine_pinot
concept_city_ansonia	concept:proxyfor	concept_stateorprovince_connecticut
concept_book_opposite	concept:proxyfor	concept_eventoutcome_new
concept_vehicle_law_enforcement	concept:atdate	concept_date_n2003
concept_river_columbia	concept:riveremptiesintoriver	concept_river_skeena_river
concept_visualizablescene_cologne	concept:atdate	concept_dateliteral_n2008
concept_bodypart_system001	concept:bodypartcontainsbodypart	concept_bodypart_tonsils
concept_lake_new	concept:locationlocatedwithinlocation	concept_city_norfolk_island
concept_charactertrait_scenes	concept:proxyfor	concept_book_new
concept_profession_consultants	concept:professionistypeofprofession	concept_profession_recruitment_professionals
concept_politician_clinton	concept:politicianusendorsedbypoliticianus	concept_politicianus_bobby_kennedy
concept_coach_pittsburgh_steelers	concept:agentcontrols	concept_sportsleague_nfl
concept_fish_recreational_fishery	concept:animalsuchasfish	concept_fish_bass
concept_software_carrier	concept:subpartof	concept_weatherphenomenon_air
concept_celltype_diseases	concept:ismultipleof	concept_celltype_women
concept_automobilemaker_toyota	concept:acquired	concept_automobilemaker_daihatsu
concept_ethnicgroup_walla_walla	concept:atlocation	concept_city_washington_d_c
concept_personeurope_james_taylor	concept:agentcollaborateswithagent	concept_person_john003
concept_profession_dispatchers	concept:professionistypeofprofession	concept_profession_support_personnel
concept_room_benefits	concept:subpartof	concept_weatherphenomenon_air
concept_election_deficiencies	concept:subpartof	concept_landscapefeatures_water
concept_crustacean_daphnia	concept:arthropodandotherarthropod	concept_crustacean_cladocerans
concept_mammal_predators	concept:animalsuchasfish	concept_fish_jacks
concept_geometricshape_bases	concept:proxyfor	concept_book_new
concept_sportsteam_chivas_usa	concept:agentcollaborateswithagent	concept_person_maykel_galindo
concept_city_taylorsville	concept:atlocation	concept_stateorprovince_utah
concept_building_dedicated	concept:atdate	concept_date_n2000
concept_visualizablescene_kings_college	concept:atlocation	concept_city_london_city
concept_terroristorganization_state	concept:agentcontrols	concept_roadaccidentevent_authorities
concept_ceo_index_this_page	concept:agentcompeteswithagent	concept_personcanada_search
concept_insect_wolf_spiders	concept:arthropodandotherarthropod	concept_arthropod_spiders
concept_transportation_firstgroup	concept:mutualproxyfor	concept_personsouthamerica_martin_gilbert
concept_city_basseterre	concept:proxyfor	concept_country_saint_kitts_and_nevis
concept_sportsteam_wipro_technologies	concept:agentcollaborateswithagent	concept_ceo_girish_paranjpe
concept_lake_new	concept:locationlocatedwithinlocation	concept_governmentorganization_employment
concept_weapon_buildings	concept:mutualproxyfor	concept_book_new
concept_website_kpix	concept:subpartof	concept_website_cbs
concept_fish_angler	concept:animalsuchasfish	concept_fish_bass
concept_county_dixie_county	concept:atlocation	concept_city_florida
concept_geopoliticallocation_khasab	concept:locationlocatedwithinlocation	concept_country_oman
concept_attraction_mississippi	concept:riveremptiesintoriver	concept_river_atchafalaya_river
concept_stateorprovince_springs	concept:proxyfor	concept_book_new
concept_election_parliamentary_elections	concept:atdate	concept_date_n2009
concept_company_nortel001	concept:acquired	concept_company_pingtel
concept_televisionstation_ktbs_tv	concept:subpartof	concept_website_abc
concept_city_malden	concept:proxyfor	concept_beach_massachusetts
concept_nerve_nerve_center	concept:proxyfor	concept_book_new
concept_book_comfort	concept:subpartof	concept_weatherphenomenon_air
concept_personus_j_d__drew	concept:agentcollaborateswithagent	concept_sportsleague_mlb
concept_company_aol	concept:agentcollaborateswithagent	concept_politicianus_jonathan_miller
concept_lake_new	concept:locationlocatedwithinlocation	concept_city_caroline
concept_personmexico_ncaa	concept:agentcontrols	concept_sportsteam_southern_methodist_mustangs
concept_politicianus_barack_obama	concept:fatherofperson	concept_person_malia
concept_city_home	concept:atdate	concept_date_apr
concept_artery_arteries	concept:arterycalledartery	concept_artery_iliac
concept_sportsleague_call	concept:agentcontrols	concept_person_mugabe
concept_university_search	concept:agentcompeteswithagent	concept_website_gigablast
concept_physiologicalcondition_pathogens	concept:ismultipleof	concept_publication_people_
concept_attraction_home_city	concept:proxyfor	concept_book_new
concept_company_satellites	concept:atdate	concept_dateliteral_n2007
concept_musicfestival_virginia_cavaliers	concept:subpartof	concept_personmexico_ncaa
concept_visualizablescene_clock	concept:thinghasshape	concept_geometricshape_round
concept_celltype_capacity	concept:subpartof	concept_visualizableattribute_sufficient_water
concept_ethnicgroup_skopje	concept:subpartof	concept_website_macedonia
concept_winery_kirkwood	concept:proxyfor	concept_company_missouri
concept_insect_insects	concept:animalsuchasinvertebrate	concept_insect_ground_beetles
concept_city_grand_canyon	concept:atlocation	concept_stateorprovince_arizona
concept_city_osage_beach	concept:proxyfor	concept_company_missouri
concept_sportsteam_knox_college	concept:agentcollaborateswithagent	concept_personmexico_ncaa
concept_female_yankees	concept:agentcollaborateswithagent	concept_politicianus_austin_jackson
concept_newspaper_journal	concept:competeswith	concept_company_institutional_investor
concept_beverage_new	concept:atlocation	concept_room_youth
concept_muscle_heart	concept:bodypartcontainsbodypart	concept_artery_large_vein
concept_biotechcompany_joy_global_inc	concept:mutualproxyfor	concept_everypromotedthing_joyg
concept_personnorthamerica_kimo	concept:agentcollaborateswithagent	concept_city_abc
concept_university_state_university	concept:synonymfor	concept_university_new_mexico_state
concept_televisionstation_ksax	concept:subpartof	concept_website_abc
concept_newspaper_wbay_tv	concept:subpartof	concept_website_abc
concept_book_years	concept:atlocation	concept_skiarea_sunshine
concept_city_iron_mountain	concept:proxyfor	concept_creditunion_michigan
concept_sportsteam_state_university	concept:teamalsoknownas	concept_sportsteam_arizona_state_university
concept_newspaper_wtvj	concept:subpartof	concept_retailstore_nbc
concept_everypromotedthing_tribune_cor	concept:atlocation	concept_highway_the_new
concept_jobposition_general_inquiries	concept:professionistypeofprofession	concept_profession_services
concept_book_casablanca	concept:mutualproxyfor	concept_personnorthamerica_neil_bogart
concept_musicsong_immigrants	concept:proxyfor	concept_weatherphenomenon_new
concept_fish_large_fish	concept:animalsuchasfish	concept_fish_wahoo
concept_politicianus_mccain	concept:politicianusendorsedbypoliticianus	concept_politicianus_lindsey_graham
concept_person_fausta	concept:parentofperson	concept_person_crispus
concept_musician_the_beach_boys	concept:agentcontrols	concept_musicartist_steve_earle
concept_university_national	concept:atlocation	concept_geopoliticallocation_clayton
concept_book_portal	concept:atdate	concept_dateliteral_n2005
concept_weapon_national	concept:atlocation	concept_city_romulus
concept_beverage_fizz	concept:beveragemadefrombeverage	concept_beverage_juice
concept_geometricshape_sense	concept:proxyfor	concept_book_new
concept_company_philips	concept:acquired	concept_company_dlo
concept_biotechcompany_fluor	concept:agentcollaborateswithagent	concept_personnorthamerica_alan_boeckmann
concept_city_kuopio	concept:locationlocatedwithinlocation	concept_country_finland
concept_programminglanguage_system	concept:subpartof	concept_hallwayitem_water_heater
concept_geometricshape_angles	concept:thinghasshape	concept_geometricshape_interior_angles
concept_mldataset_elite	concept:proxyfor	concept_book_new
concept_musicartist_countdown	concept:agentcontrols	concept_city_number
concept_lake_new	concept:locationlocatedwithinlocation	concept_country_new_south_wales
concept_beach_center_hill	concept:atlocation	concept_city_florida
concept_televisionstation_wroc	concept:subpartof	concept_website_cbs
concept_lake_new	concept:locationlocatedwithinlocation	concept_hotel_flag
concept_city_guilford	concept:atlocation	concept_stateorprovince_connecticut
concept_sportsteam_ferris_state_bulldogs	concept:agentcollaborateswithagent	concept_personmexico_ncaa
concept_sportsleague_western_conference	concept:agentcontrols	concept_sportsteam_la_clippers
concept_hobby_estimate	concept:proxyfor	concept_book_new
concept_company_giant	concept:proxyfor	concept_book_new
concept_beverage_sprite	concept:beveragemadefrombeverage	concept_beverage_juice
concept_geometricshape_sphere	concept:thinghasshape	concept_geometricshape_shape
concept_city_abc	concept:agentcontrols	concept_website_wtvc
concept_visualizablething_one_afternoon	concept:atdate	concept_date_n1996
concept_city_munfordville	concept:proxyfor	concept_coach_kentucky
concept_physicsterm_forces	concept:proxyfor	concept_book_new
concept_scientificterm_latent_semantic_analysis	concept:conceptprerequisiteof	concept_scientificterm_probabilistic_latent_semantic_analysis
concept_company_new_york	concept:competeswith	concept_politicsblog_bookforum
concept_lake_new	concept:locationlocatedwithinlocation	concept_website_snap
concept_lake_new	concept:locationlocatedwithinlocation	concept_mountainrange_plants
concept_geometricshape_centroid	concept:thinghasshape	concept_geometricshape_triangle
concept_televisionstation_west_memphis	concept:proxyfor	concept_book_arkansas
concept_visualizablething_clear_water	concept:atlocation	concept_city_florida
concept_monument_honest_abe	concept:synonymfor	concept_river_brad
concept_beverage_cointreau	concept:beveragemadefrombeverage	concept_beverage_juice
concept_recipe_basic	concept:synonymfor	concept_university_microsoft
concept_tradeunion_engineers	concept:subpartof	concept_weatherphenomenon_water
concept_mountain_fox	concept:agentcontrols	concept_website_ksaz_tv
concept_company_nbc	concept:agentcontrols	concept_website_ksee_tv
concept_biotechcompany_sydney	concept:atdate	concept_year_n1828
concept_geopoliticallocation_nv	concept:subpartof	concept_country_usa
concept_beverage_peach_schnapps	concept:beveragemadefrombeverage	concept_beverage_juice
concept_sportsteam_louisiana_monroe_warhawks	concept:agentcollaborateswithagent	concept_personmexico_ncaa
concept_sportsteam_faulkner_state_sun_chiefs	concept:agentcollaborateswithagent	concept_personmexico_ncaa
concept_ceo_ken_chenault	concept:proxyfor	concept_musicinstrument_american_express
concept_biotechcompany_medtronic	concept:acquired	concept_biotechcompany_kyphon
concept_food_legumes	concept:agriculturalproductincludingagriculturalproduct	concept_agriculturalproduct_lentils
concept_personmexico_ncaa	concept:agentcontrols	concept_sportsteam_southern_mississippi_golden_eagles
concept_lake_new	concept:locationlocatedwithinlocation	concept_monument_parade
concept_biotechcompany_monsanto	concept:acquired	concept_biotechcompany_searle
concept_room_systems	concept:subpartof	concept_visualizablething_ventilation
concept_bathroomitem_creative	concept:mutualproxyfor	concept_person_robin_bronk
concept_governmentorganization_red_cross	concept:mutualproxyfor	concept_disease_cpr
concept_buildingfeature_systems	concept:subpartof	concept_chemical_waste_management
concept_jobposition_guest_speaker	concept:proxyfor	concept_book_new
concept_weapon_national	concept:atlocation	concept_zoo_theodore
concept_city_la_romana	concept:locationlocatedwithinlocation	concept_country_dominican_republic
concept_profession_disc_jockeys	concept:professionistypeofprofession	concept_profession_professionals
concept_geometricshape_variables	concept:subpartof	concept_weatherphenomenon_water
concept_eventoutcome_wonderful_experience	concept:proxyfor	concept_book_new
concept_governmentorganization_appeals_court	concept:atdate	concept_dateliteral_n2007
concept_celebrity_aruba	concept:atdate	concept_dateliteral_n2006
concept_parlourgame_n1_2_years	concept:proxyfor	concept_book_new
concept_company_new_york	concept:competeswith	concept_politicsblog_the_economist
concept_jobposition_hardware	concept:atdate	concept_dateliteral_n2007
concept_year_new	concept:mutualproxyfor	concept_musicsong_brother
concept_vehicle_cab	concept:subpartof	concept_weatherphenomenon_air
concept_academicfield_sciences	concept:academicfieldsuchasacademicfield	concept_academicfield_natural_resources
concept_blog_krnv_tv	concept:agentcollaborateswithagent	concept_company_nbc
concept_river_sava	concept:riveremptiesintoriver	concept_river_danube
concept_bodypart_blood	concept:bodypartcontainsbodypart	concept_braintissue_rhythm
concept_coach_toronto_maple_leafs	concept:atlocation	concept_city_montreal
concept_city_hillsborough	concept:proxyfor	concept_stateorprovince_newjersey
concept_company_dc	concept:competeswith	concept_politicsblog_united_press_international
concept_fish_pelagic	concept:animalsuchasfish	concept_fish_sharks
concept_book_new	concept:atlocation	concept_planet_efforts
concept_musicgenre_ska_punk	concept:musicgenressuchasmusicgenres	concept_musicgenre_rock
concept_river_saint_george	concept:locationlocatedwithinlocation	concept_county_utah
concept_beverage_apple_cider_vinegar	concept:beveragemadefrombeverage	concept_beverage_juice
concept_city_fallon	concept:atlocation	concept_stateorprovince_nevada
concept_city_ocean_grove	concept:mutualproxyfor	concept_radiostation_new_jersey
concept_company_nbc	concept:agentcontrols	concept_website_wsmv
concept_politicsblog_wgal	concept:agentcollaborateswithagent	concept_company_nbc
concept_biotechcompany_best_buy_inc	concept:mutualproxyfor	concept_cardgame_bby
concept_lake_new	concept:locationlocatedwithinlocation	concept_retailstore_homeland
concept_musicartist_george	concept:atlocation	concept_city_washington_d_c
concept_geopoliticalorganization_caribbean	concept:proxyfor	concept_lake_new
concept_city_laconia	concept:atlocation	concept_stateorprovince_new_hampshire
concept_coach_new	concept:subpartof	concept_director_summers
concept_televisionshow_tombstone	concept:subpartof	concept_beverage_arizona
concept_company_united_states_centers_for_disease_prevention_and_control	concept:mutualproxyfor	concept_person_julie_gerberding
concept_musicgenre_hiphop	concept:musicgenressuchasmusicgenres	concept_musicgenre_rap
concept_city_mahwah	concept:proxyfor	concept_stateorprovince_new_jersey
concept_river_russian_river	concept:riveremptiesintoriver	concept_river_dry_creek
concept_personcanada_search	concept:agentcompeteswithagent	concept_magazine_stuff
concept_researchproject_planning_grant	concept:atdate	concept_dateliteral_n2007
concept_website_foreclosure	concept:atdate	concept_dateliteral_n2008
concept_city_milledgeville	concept:locationlocatedwithinlocation	concept_stateorprovince_georgia
concept_stadiumoreventvenue_gonzaga_university	concept:atlocation	concept_visualizablething_spokane
concept_comedian_davenport	concept:proxyfor	concept_governmentorganization_iowa
concept_musicinstrument_composer	concept:proxyfor	concept_book_new
concept_county_opp	concept:atlocation	concept_stateorprovince_alabama
concept_televisionstation_service_area	concept:subpartof	concept_recordlabel_water
concept_sportsteam_houston_comets	concept:agentcollaborateswithagent	concept_athlete_sheryl_swoopes
concept_city_kosice	concept:locationlocatedwithinlocation	concept_country_slovakia
concept_city_abc	concept:agentcontrols	concept_website_katc
concept_stadiumoreventvenue_manchester_city	concept:subpartof	concept_geopoliticallocation_fa
concept_bodypart_blood	concept:bodypartcontainsbodypart	concept_braintissue_case
concept_company_microsoft	concept:organizationalsoknownas	concept_biotechcompany_msft_
concept_hotel_pro_player_stadium	concept:atlocation	concept_county_miami
concept_coach_new	concept:mutualproxyfor	concept_sport_possession
concept_male_avraham	concept:fatherofperson	concept_male_yitzchok
concept_insect_sac_spiders	concept:arthropodandotherarthropod	concept_arthropod_spiders
concept_musicsong_toast	concept:proxyfor	concept_weatherphenomenon_new
concept_lake_new	concept:locationlocatedwithinlocation	concept_transportation_fare
concept_city_paradise	concept:mutualproxyfor	concept_stateorprovince_california
concept_buildingfeature_foundation	concept:subpartof	concept_weatherphenomenon_water
concept_politicsblog_cnn	concept:agentcollaborateswithagent	concept_person_lou_dobbs
concept_hallwayitem_sc	concept:mutualproxyfor	concept_shoppingmall_columbia
concept_stateorprovince_nec	concept:atdate	concept_date_n2004
concept_company_cnn001	concept:organizationalsoknownas	concept_website_cable_news_network
concept_musicsong_twenty_years	concept:proxyfor	concept_weatherphenomenon_new
concept_academicfield_maps	concept:subpartof	concept_weatherphenomenon_water
concept_biotechcompany_novell	concept:acquired	concept_company_digital_research
concept_televisionshow_last_wednesday	concept:atdate	concept_date_community
concept_televisionstation_whtm_tv	concept:subpartof	concept_website_abc
concept_geopoliticallocation_kodiak	concept:atlocation	concept_city_alaska
concept_musicfestival_first_workshop	concept:atdate	concept_dateliteral_n2005
concept_buildingfeature_offers	concept:subpartof	concept_weatherphenomenon_air
concept_city_saint_george_s	concept:proxyfor	concept_city_grenada
concept_vegetable_employer	concept:proxyfor	concept_beverage_new
concept_vehicle_lumberton	concept:mutualproxyfor	concept_radiostation_new_jersey
concept_automobilemaker_gm	concept:acquired	concept_automobilemaker_vauxhall
concept_musicartist_dave_clark_five	concept:agentcollaborateswithagent	concept_politicianus_mike_smith
concept_fish_squadron	concept:atdate	concept_date_n1942
concept_fish_rock_bass	concept:animalistypeofanimal	concept_fish_panfish
concept_automobilemaker_china	concept:agentcompeteswithagent	concept_tradeunion_article
concept_academicfield_actuarial_science	concept:academicfieldsuchasacademicfield	concept_academicfield_operations_research
concept_book_new	concept:atlocation	concept_planet_effect
concept_terroristorganization_harkat_ul_mujahideen	concept:organizationalsoknownas	concept_organization_movement_of_holy_warriors
concept_river_columbia	concept:riveremptiesintoriver	concept_river_peace_river
concept_musicartist_abbas	concept:agentcontrols	concept_planet_forces
concept_politicsbill_agreements	concept:subpartof	concept_weatherphenomenon_water
concept_artery_arteries	concept:arterycalledartery	concept_artery_left_subclavian
concept_geopoliticallocation_national	concept:atlocation	concept_city_bell_gardens
concept_blog_wjac_tv	concept:subpartof	concept_retailstore_nbc
concept_automobilemaker_volkswagen_group	concept:acquired	concept_automobilemaker_bentley
concept_chemical_fluorides	concept:chemicalistypeofchemical	concept_chemical_water
concept_militaryconflict_first_gulf_war	concept:atdate	concept_year_n1991
concept_academicfield_science	concept:academicfieldsuchasacademicfield	concept_academicfield_engineering_management
concept_company_nbc	concept:agentcontrols	concept_televisionstation_ktve_tv
concept_shoppingmall_pine_island	concept:atlocation	concept_city_florida
concept_militaryconflict_european_theater	concept:atdate	concept_date_n1942
concept_male_agamemnon	concept:hassibling	concept_person_menelaus
concept_radiostation_kmph	concept:agentcollaborateswithagent	concept_mountain_fox
concept_city_omaha	concept:cityalsoknownas	concept_city_creighton
concept_buildingfeature_american	concept:atlocation	concept_city_avondale_estates
concept_musicinstrument_mortgage	concept:proxyfor	concept_book_new
concept_perceptionevent_flash	concept:synonymfor	concept_company_macromedia
concept_bodypart_atrium	concept:bodypartcontainsbodypart	concept_bodypart_pulmonary_circulation
concept_personmexico_ncaa	concept:agentcontrols	concept_sportsteam_texas_state_bobcats
concept_city_denver	concept:subpartof	concept_sport_heating_and_air
concept_company_amazon_com_inc	concept:acquired	concept_company_abebooks
concept_automobilemodel_same_year	concept:proxyfor	concept_book_new
concept_stateorprovince_agartala	concept:mutualproxyfor	concept_geopoliticallocation_tripura
concept_politician_dnc	concept:agentcollaborateswithagent	concept_politicianus_howard_dean
concept_buildingfeature_systems	concept:subpartof	concept_beverage_independent_water
concept_musician_blues_traveler	concept:agentcontrols	concept_actor_john_popper
concept_beverage_brown_sugar	concept:beveragemadefrombeverage	concept_beverage_juice
concept_mldataset_n50	concept:proxyfor	concept_book_new
concept_personmexico_boise_state	concept:agentcollaborateswithagent	concept_coach_chris_petersen
concept_highway_delaware_river	concept:proxyfor	concept_book_new
concept_blog_sandusky	concept:proxyfor	concept_university_ohio
concept_televisionstation_kuen	concept:subpartof	concept_museum_pbs
concept_musicartist_soul_coughing	concept:agentcollaborateswithagent	concept_musicartist_mike_doughty
concept_city_tehran	concept:atdate	concept_dateliteral_n2006
concept_artery_vessels	concept:arterycalledartery	concept_artery_capillary
concept_sportsteam_georgia_southwestern_hurricanes	concept:agentcollaborateswithagent	concept_personmexico_ncaa
concept_politicsissue_one_thing	concept:proxyfor	concept_book_new
concept_personeurope_cheek	concept:subpartof	concept_website_blood
concept_book_new	concept:atlocation	concept_planet_shape
concept_musicartist_oxen	concept:agentcompeteswithagent	concept_animal_animals001
concept_personmexico_ncaa	concept:agentcontrols	concept_sportsteam_unc_wilmington_seahawks
concept_vehicle_suppliers	concept:atdate	concept_dateliteral_n2005
concept_restaurant_town	concept:locationlocatedwithinlocation	concept_building_vegas
concept_newspaper_akron_beacon_journal	concept:agentcollaborateswithagent	concept_journalist_sheldon_ocker
concept_city_papillion	concept:proxyfor	concept_university_nebraska
concept_city_abuja	concept:proxyfor	concept_country_nigeria
concept_biotechcompany_cvs	concept:acquired	concept_biotechcompany_caremark
concept_personeurope_jerry_colangelo	concept:proxyfor	concept_website_suns
concept_profession_staff	concept:professionistypeofprofession	concept_profession_professional_educators
concept_televisionstation_wned_tv	concept:subpartof	concept_museum_pbs
concept_visualizablething_millennia	concept:atlocation	concept_hotel_north
concept_city_ft__myers	concept:proxyfor	concept_city_florida
concept_company_new_york	concept:competeswith	concept_magazine_hollywood_reporter
concept_retailstore_ebay	concept:synonymfor	concept_retailstore_ebay_inc_
concept_musicalbum_teenager	concept:proxyfor	concept_weatherphenomenon_new
concept_automobilemaker_video	concept:competeswith	concept_company_yahoo001
concept_personmexico_baltimore_orioles	concept:agentcompeteswithagent	concept_female_yankees
concept_street_green_bank	concept:proxyfor	concept_stateorprovince_newjersey
concept_newspaper_journal	concept:competeswith	concept_publication_american_lawyer
concept_academicfield_science	concept:academicfieldsuchasacademicfield	concept_academicfield_aeronautics
concept_artery_ventricle	concept:bodypartcontainsbodypart	concept_artery_semilunar_valve
concept_televisionstation_wkrn_tv	concept:subpartof	concept_website_abc
concept_profession_curriculum	concept:professionistypeofprofession	concept_profession_professionals
concept_jobposition_internal_medicine	concept:atdate	concept_dateliteral_n2008
concept_river_rio_negro	concept:riveremptiesintoriver	concept_river_amazon_river
concept_scientist_edmond	concept:proxyfor	concept_musicsong_oklahoma
concept_retailstore_honda_motor	concept:mutualproxyfor	concept_musicartist_takeo_fukui
concept_fish_poppers	concept:animalsuchasfish	concept_fish_bass
concept_weatherphenomenon_greater	concept:proxyfor	concept_stateorprovince_california
concept_city_menomonee_falls	concept:atlocation	concept_stateorprovince_wisconsin
concept_book_suburbs	concept:proxyfor	concept_book_all_new
concept_visualizablescene_thanjavur	concept:proxyfor	concept_stateorprovince_tamil_nadu
concept_city_celaya	concept:locationlocatedwithinlocation	concept_country_mexico
concept_chemical_dioxide	concept:chemicalistypeofchemical	concept_visualizablething_malt
concept_nonprofitorganization_home_team	concept:proxyfor	concept_book_new
concept_city_bloomingdale	concept:subpartof	concept_stateorprovince_illinois
concept_room_back	concept:subpartof	concept_academicfield_one_hand
concept_sportsteam_lewis_flyers	concept:agentcollaborateswithagent	concept_personmexico_ncaa
concept_sportsleague_mlb	concept:agentcontrols	concept_female_angels
concept_landscapefeatures_climate_change	concept:atdate	concept_dateliteral_n2007
concept_biotechcompany_apple	concept:agentcontrols	concept_island_steven
concept_tableitem_chennai	concept:atdate	concept_date_n2001
concept_city_opole	concept:locationlocatedwithinlocation	concept_country_poland
concept_weapon_national	concept:atlocation	concept_city_essington
concept_agriculturalproduct_leafy_vegetables	concept:agriculturalproductincludingagriculturalproduct	concept_vegetable_lettuce
concept_crustacean_nit	concept:agentcompeteswithagent	concept_university_unc_asheville
concept_sportsteam_morehead_state_eagles	concept:agentcollaborateswithagent	concept_personmexico_ncaa
concept_programminglanguage_principal	concept:proxyfor	concept_book_new
concept_city_amsterdam_amsterdam	concept:locationlocatedwithinlocation	concept_country_netherlands
concept_governmentorganization_government	concept:agentcontrols	concept_musicsong_loans
concept_musicartist_santana	concept:agentcollaborateswithagent	concept_person_john003
concept_televisionstation_wmht	concept:subpartof	concept_museum_pbs
concept_company_fcc	concept:mutualproxyfor	concept_coach_michael_powell
concept_company_seagate	concept:acquired	concept_company_maxtor
concept_personmexico_ncaa	concept:agentcontrols	concept_sportsteam_florida_atlantic_owls
concept_musicartist_fairs	concept:proxyfor	concept_book_new
concept_nut_raising	concept:ismultipleof	concept_nut_horses
concept_vehicle_states	concept:atlocation	concept_lake_mid_atlantic
concept_musician_complete	concept:agentcollaborateswithagent	concept_politicianus_form
concept_bodypart_head001	concept:subpartof	concept_videogame_adrenaline
concept_city_home	concept:atdate	concept_date_christmas_day
concept_sportsteam_se_missouri_state	concept:agentcollaborateswithagent	concept_personmexico_ncaa
concept_sportsteam_lipscomb_bisons	concept:agentcollaborateswithagent	concept_personmexico_ncaa
concept_city_karshi	concept:locationlocatedwithinlocation	concept_country_uzbekistan
concept_city_nidaros	concept:cityalsoknownas	concept_city_trondheim
concept_city_stirling	concept:proxyfor	concept_stateorprovince_new_jersey
concept_musicartist_american	concept:atlocation	concept_stateorprovince_waipahu
concept_jobposition_maid	concept:proxyfor	concept_book_new
concept_televisionstation_kgmb	concept:subpartof	concept_website_cbs
concept_person_engineer	concept:proxyfor	concept_book_new
concept_lake_new	concept:locationlocatedwithinlocation	concept_park_tournaments
concept_fish_yellow_perch	concept:animalistypeofanimal	concept_fish_panfish
concept_county_coal_valley	concept:atlocation	concept_stateorprovince_illinois
concept_city_bradford	concept:atlocation	concept_stateorprovince_pennsylvania
concept_blog_techcrunch	concept:subpartof	concept_personus_michael_arrington
concept_televisionstation_indianapolis	concept:proxyfor	concept_stadiumoreventvenue_murat_theatre
concept_beach_guam	concept:atdate	concept_dateliteral_n1945
concept_city_evergreen	concept:subpartof	concept_ceo_chang_yung_fa
concept_university_state_university	concept:synonymfor	concept_university_depauw
concept_company_new_york	concept:competeswith	concept_blog_slashdot
concept_governmentorganization_miami_dade_county	concept:agentcollaborateswithagent	concept_organization_miami_dade_county_public_schools
concept_crimeorcharge_corruption_charges	concept:atdate	concept_dateliteral_n2006
concept_scientificterm_k_nearest_neighbors	concept:conceptprerequisiteof	concept_scientificterm_the_curse_of_dimensionality
concept_lake_new	concept:locationlocatedwithinlocation	concept_room_breakfast
concept_politicsissue_lake_county	concept:atlocation	concept_city_florida
concept_city_rio_vista	concept:atlocation	concept_stateorprovince_california
concept_website_overstock	concept:agentcontrols	concept_musicinstrument_patrick_byrne
concept_visualizablescene_pool	concept:atdate	concept_dateliteral_n2007
concept_city_fernandina_beach	concept:atlocation	concept_city_florida
concept_geopoliticallocation_bal_harbour	concept:atlocation	concept_city_florida
concept_academicfield_technology	concept:academicfieldsuchasacademicfield	concept_academicfield_industrial_and_systems_engineering
concept_city_abc	concept:agentcontrols	concept_company_wjla
concept_city_chihuahua	concept:proxyfor	concept_country_mexico
concept_artery_blood_vessels	concept:arterycalledartery	concept_artery_microvessels
concept_city_spearfish	concept:atlocation	concept_stateorprovince_south_dakota
concept_mammal_lemmings	concept:animalistypeofanimal	concept_mammal_rodents
concept_buildingfeature_american	concept:atlocation	concept_city_morrisville
concept_race_day_trip	concept:proxyfor	concept_politicaloffice_new
concept_city_kiruna	concept:locationlocatedwithinlocation	concept_city_sweden
concept_company_video	concept:competeswith	concept_website_metacafe
concept_city_chardon	concept:atlocation	concept_stateorprovince_ohio
concept_musicsong_apache	concept:synonymfor	concept_agent_linux
concept_academicfield_science	concept:academicfieldsuchasacademicfield	concept_academicfield_electrical_and_electronic_engineering
concept_scientificterm_weight_decay_in_neural_networks	concept:conceptprerequisiteof	concept_scientificterm_soft_weight_sharing_in_neural_nets
concept_university_liverpool_john_moores_university	concept:agentcompeteswithagent	concept_university_a_m_
concept_buildingfeature_operators	concept:subpartof	concept_visualizablething_water_supply
concept_city_leicester	concept:atdate	concept_dateliteral_n2006
concept_university_westwood	concept:proxyfor	concept_radiostation_new_jersey
concept_reptile_diamondbacks	concept:atlocation	concept_city_phoenix
concept_book___	concept:proxyfor	concept_eventoutcome_new
concept_food_oil	concept:agriculturalproductincludingagriculturalproduct	concept_food_oyster
concept_bone_ankle	concept:subpartof	concept_website_blood
concept_agriculturalproduct_products	concept:agriculturalproductincludingagriculturalproduct	concept_food_meal
concept_city_normal	concept:proxyfor	concept_stadiumoreventvenue_braden_auditorium
concept_televisionstation_kfda_tv	concept:subpartof	concept_website_cbs
concept_personus_italians	concept:atdate	concept_dateliteral_n1943
concept_emotion_destruction	concept:atdate	concept_date_n2003
concept_stateorprovince_states	concept:stateorprovinceisborderedbystateorprovince	concept_stateorprovince_nb
concept_geopoliticallocation_dundee	concept:atdate	concept_dateliteral_n2005
concept_artery_cord	concept:bodypartcontainsbodypart	concept_bodypart_fluid_space
concept_city_metuchen	concept:proxyfor	concept_stateorprovince_new_jersey
concept_company_new_york	concept:competeswith	concept_magazine_popular_science
concept_trainstation_chatsworth	concept:proxyfor	concept_radiostation_new_jersey
concept_city_deadwood	concept:atlocation	concept_stateorprovince_south_dakota
concept_agriculturalproduct_products	concept:agriculturalproductincludingagriculturalproduct	concept_food_sugars
concept_company_new_york	concept:competeswith	concept_televisionstation_baltimore_sun
concept_chemical_water	concept:chemicalistypeofchemical	concept_visualizablething_colorants
concept_book_years	concept:atlocation	concept_geopoliticallocation_miss
concept_person_roman	concept:hassibling	concept_monarch_diocletian
concept_blog_roger_ailes	concept:proxyfor	concept_year_fox_news
concept_visualizableobject_head001	concept:subpartof	concept_hallwayitem_much_blood
concept_academicfield_technology	concept:academicfieldsuchasacademicfield	concept_academicfield_metallurgy
concept_televisionstation_wkaq_tv	concept:agentcollaborateswithagent	concept_company_telemundo
concept_bank_bank_of_america_pavilion	concept:atlocation	concept_city_boston
concept_website_koco_tv	concept:subpartof	concept_website_abc
concept_televisionstation_wdsu	concept:agentcollaborateswithagent	concept_company_nbc
concept_weapon_united_states_navy	concept:atdate	concept_date_n1941
concept_charactertrait_favor	concept:atdate	concept_dateliteral_n2002
concept_city_kilgore	concept:atlocation	concept_stateorprovince_texas
concept_musicalbum_death	concept:atdate	concept_date_n1782
concept_city_silver_city	concept:proxyfor	concept_stateorprovince_new_mexico
concept_perceptionaction_teleconference	concept:atdate	concept_dateliteral_n2006
concept_automobilemaker_ford	concept:acquired	concept_automobilemaker_land_rover
concept_scientist_howard_kurtz	concept:agentcollaborateswithagent	concept_personcanada_post
concept_politicalparty_alternative	concept:proxyfor	concept_emotion_new
concept_musicgenre_electronic	concept:musicgenressuchasmusicgenres	concept_musicgenre_rock
concept_city_paragould	concept:locationlocatedwithinlocation	concept_stateorprovince_arkansas
concept_weapon_national	concept:atlocation	concept_island_bainbridge_island
concept_lake_new	concept:locationlocatedwithinlocation	concept_room_master
concept_automobilemaker_n2_0	concept:proxyfor	concept_book_new
concept_geopoliticalorganization_such_state	concept:proxyfor	concept_book_new
concept_bodypart_system001	concept:bodypartcontainsbodypart	concept_artery_healthy_heart
concept_animal_pet	concept:animalpreyson	concept_vertebrate_beloved_pets
concept_personcanada_search	concept:agentcompeteswithagent	concept_politicalparty_types
concept_academicfield_public_health	concept:academicfieldsuchasacademicfield	concept_academicfield_plant_biology
concept_everypromotedthing_software_tag	concept:synonymfor	concept_visualizablescene_popular
concept_lake_new	concept:locationlocatedwithinlocation	concept_room_air
concept_person_apollo	concept:hassibling	concept_personafrica_python
concept_sportsequipment_terms	concept:thinghasshape	concept_geometricshape_triangle
concept_street_pinehurst	concept:atlocation	concept_stateorprovince_north_carolina
concept_candy_great_value	concept:proxyfor	concept_book_new
concept_personus_stan_javier	concept:parentofperson	concept_personmexico_julian_javier
